START:2,10
TOTAL_TILES:20
COIN_BAGS:
KEYS:
BLOCKS:
TELEPORTS:
1111111111111111111
1111111111111111111
1111111111111111111
1111111111111111111
1111111111111111111
1111111111111111111
1111111111111111111
1111111111111191111
11111111111111B1111
11111111111111B1111
11ABBBB111BBBBB1111
111111B111B11111111
111111BBBBB11111111
1111111111111111111
1111111111111111111