START:14,7
TOTAL_TILES:42
COIN_BAGS:9,10
KEYS:
BLOCKS:
TELEPORTS:
1111111111111111111
1111111111111111111
1111111111111111111
1111111111111111111
1111111111111111111
1111111111111111111
1111111111111111111
11111111111111A1111
11111111111111B1111
1111BBBBBBBBBBBBB11
119BBBBBB8BBBBBBB11
11111BBBBBBBBBBBB11
1111111111111111111
1111111111111111111
1111111111111111111
