START:14,7
TOTAL_TILES:26
COIN_BAGS:
KEYS:
BLOCKS:
TELEPORTS:
1111111111111111111
1111111111111111111
1111111111111111111
1111111111111111111
1111111111111111111
1111111111111111111
1111111111111111111
11191111111111A1111
111B1111111111B1111
111B111111BB11B1111
111BBBBBBBBBBBB1111
111BB11BB1111BB1111
1111111111111111111
1111111111111111111
1111111111111111111