START:3,7
TOTAL_TILES:44
COIN_BAGS:7,7
KEYS:
BLOCKS:
TELEPORTS:
0000000000000000000
0111110000001111100
01BBB11111111BBB100
01BBB11BBBB11BBB100
011BBBBBBBBBBBB1100
001B1111BB1111B1000
001B101BBBB101B1000
001A1018BBB10191000
0011101111110111000
0000000000000000000
0000000000000000000
0000000000000000000
0000000000000000000
0000000000000000000
0000000000000000000
