START:2,10
TOTAL_TILES:42
COIN_BAGS:10,11
KEYS:
BLOCKS:
TELEPORTS:
0000000000000000000
0000000000000000000
0000000000000000000
0000000000000000000
0000000000000000000
0000000000000000000
0000000000000111000
0000001111100191000
0001111BBB1111B1110
0111BBBBBBBBB1BBB10
01ABBBBBBBBBB1BBB10
01111BBB1B8BBBBBB10
0000111111111111110
0000000000000000000
0000000000000000000
