START:14,7
TOTAL_TILES:94
COIN_BAGS:6,3
KEYS:
BLOCKS:
TELEPORTS:
0111111111111111100
01BBBBBBBBBBBBBB110
01B1111BCBBBBBBCB10
01BCBB8BBBBBBBBBB10
01BC11111B1111B1110
01BC1111191BB1B1000
01BC1111111BB1B1000
01BB1111BBBBB1A1000
01BBBCCBB111B111000
01B1BBBBB111B100000
01BBB111BBBBB100000
0111110111111100000
0000000000000000000
0000000000000000000
0000000000000000000
