1111111111111111111
1222222221331332221
1212222222333321221
1222122222333321411
1222222222333321291
1222223338322221111
1222223233322222221
1222223222222222221
1133362222223222221
1D33332222222222221
1221222222222211221
1222222222222211111
12121A1212222222221
1222111222222222221
1111111111111111111
