1111111111111111111
11B2222222222222281
1522222222222227221
1111122232222222221
1111121732222222121
111A221232222222121
1111111222222222221
1119221222222222221
1111141222222222121
1111133222122222121
1222322222122222621
1211321222222222221
1211332222222222121
1222321122112212221
1111111111111111111
