0000000000000011100
0000000000000019100
0000000000001112111
0011111111111223221
0012222222211312131
0012221111221323231
0012222321221112111
0111321221223212111
0122311121112114111
012122B132222123331
0121212131222121131
012231212122212A131
0111223321222111131
0001221281223333331
0001111111111111111
