0000000111101110000
0011111122111210000
0012212223223310000
0012222222112210000
0012111222222211000
0012151111133321000
0013222222232211000
0012121128233310000
1112121222222310000
1B12161222233310000
1312121111132111110
131232192423112A210
1311311111122232210
1333310000111111110
1111110000000000000
