0000000000000000000
0000000000000000000
0000000000000000000
0000000000000000000
0000000000000000000
0000000000000000000
0011100000000111000
00191000000001A1000
0012111110000121000
0012112211111121000
0012222222222221000
0012211112211221000
0011110011111111000
0000000000000000000
0000000000000000000
