1111111111111111111
1B22222222222222221
1222333333332222321
1222222222222222321
1222222111111222321
122222211A113382321
1222222112113322221
1222222222222222221
1222222222222222221
1222222111222211121
1222222222333342121
1221122111222219121
1221133221222211121
1222222222222222221
1111111111111111111
