0000000000000000000
0111110000001111100
0122211111111222100
0122211222211222100
0112222222222221100
0012111122111121000
0012101222210121000
001A101822210191000
0011101111110111000
0000000000000000000
0000000000000000000
0000000000000000000
0000000000000000000
0000000000000000000
0000000000000000000
