0000000000000000000
0000000000000000000
0000000000000000000
0000000000000000000
0000000000000000000
0000000000000000000
0011100000000111000
00191000000001A1000
0012100001111121000
0012111111221121000
0012222222222221000
0012211221111221000
0011111111001111000
0000000000000000000
0000000000000000000
