1111110001111000000
1222210001221110000
1222211101222210000
1122228111222211000
0122223221222321100
1121122121122232100
1221122232222221110
1222122322222222B10
1222121611121222210
1122122322132221110
1121111112122232100
0121111A22122321100
0124291222122211000
0151111222112210000
0111001111111110000
