0000000000000000000
0000000000000000000
0000000000000000000
0000000000000000000
0000000000000000000
0000000000000000000
0000000000000111000
0000000000000191000
0000111111111121110
0111122212222122210
01A2222222222122210
0111222222822222210
0001111222111111110
0000001111100000000
0000000000000000000
