START:4,9
TOTAL_TILES:16
COIN_BAGS:
KEYS:
BLOCKS:
TELEPORTS:
1111111111111111111
1111111111111111111
1111111111111111111
1111111111111111111
1111111111111111111
1111111111111111111
1111111111111111111
1111111111111111111
11111BB111111111111
1111ABBBB1111111111
11111111BB111111111
111111111BBB1111111
11111111111BB111111
111111111111BB91111
1111111111111111111
