START:6,0
TOTAL_TILES:16
COIN_BAGS:
KEYS:
BLOCKS:
TELEPORTS:
111111ABB1111111111
111111BBB1111111111
111111BBBB111111111
1111111BBB111111111
1111119B11111111111
111111BB11111111111
1111111111111111111
1111111111111111111
1111111111111111111
1111111111111111111
1111111111111111111
1111111111111111111
1111111111111111111
1111111111111111111
1111111111111111111
