START:1,10
TOTAL_TILES:16
COIN_BAGS:
KEYS:
BLOCKS:
TELEPORTS:
1111111111111111111
1111111111111111111
1111111111111111111
1111111111111111111
1111111111111111111
1111111111111111111
1111111111111111111
1111111111111111111
1111111111111111111
9111111111111111111
BA11111111111111111
BB11111111111111111
BBBB111111111111111
BBBB111111111111111
BBBB111111111111111
