START:10,4
TOTAL_TILES:16
COIN_BAGS:
KEYS:
BLOCKS:
TELEPORTS:
1111111111111111111
1111111111111111111
1111111111111111111
1111111111111111111
1111111111A11111111
1111111111B11111111
1111111111BB1111111
1111111111BB1111111
111111BB1BB11111111
111111BBBB111111111
111111BB11111111111
1111111911111111111
1111111111111111111
1111111111111111111
1111111111111111111
