START:13,12
TOTAL_TILES:16
COIN_BAGS:
KEYS:
BLOCKS:
TELEPORTS:
1111111111111111111
1111111111111111111
1111111111111111111
1111111111111111111
1111111111111111111
1111111111111111111
1111111111111111111
1111111111111111111
1111111BBB111111111
1111119B1B111111111
111111111B1BB111111
111111111BBBBB11111
1111111111BB1A11111
1111111111111111111
1111111111111111111
