START:18,11
TOTAL_TILES:16
COIN_BAGS:
KEYS:
BLOCKS:
TELEPORTS:
1111111111111111111
1111111111111111111
111111111111111119B
1111111111111111BBB
1111111111111111BBB
1111111111111111B11
1111111111111111BBB
111111111111111111B
111111111111111111B
111111111111111111B
111111111111111111B
111111111111111111A
1111111111111111111
1111111111111111111
1111111111111111111
