START:12,12
TOTAL_TILES:16
COIN_BAGS:
KEYS:
BLOCKS:
TELEPORTS:
1111111111111111111
1111111111111111111
1111111111111111111
1111111111111111111
11111111119BB111111
111111111111BB11111
1111111111111B11111
1111111111111B11111
1111111111111B11111
111111111111BB11111
11111111111BB111111
11111111111B1111111
11111111111BA111111
11111111111BB111111
1111111111111111111
