START:13,2
TOTAL_TILES:16
COIN_BAGS:
KEYS:
BLOCKS:
TELEPORTS:
1111111111111111111
1111111111BBBB11111
11111111BBB11A11111
11111111BB111111111
11111111BB111111111
11111111B1111111111
11111111BBB11111111
1111111111911111111
1111111111111111111
1111111111111111111
1111111111111111111
1111111111111111111
1111111111111111111
1111111111111111111
1111111111111111111
