START:9,8
TOTAL_TILES:16
COIN_BAGS:
KEYS:
BLOCKS:
TELEPORTS:
1111111111111111111
1111111111111111111
1111111111111111111
1111111111111111111
11111119BBB11111111
1111111BBBB11111111
111111111BBB1111111
11111111111B1111111
111111111ABB1111111
1111111111BB1111111
1111111111111111111
1111111111111111111
1111111111111111111
1111111111111111111
1111111111111111111
