START:13,7
TOTAL_TILES:16
COIN_BAGS:
KEYS:
BLOCKS:
TELEPORTS:
1111111111111111111
1111111111111111111
1111111111111111111
1111111111111111111
1111111111111111111
1111111111111111111
1111111111111111111
1111111111111A11111
1111111111111B11111
1111111111111B11111
111111111111BB11111
111111111111BB11111
111111111111BB11111
111111111111B119B11
111111111111BBBBB11
