START:0,9
TOTAL_TILES:16
COIN_BAGS:
KEYS:
BLOCKS:
TELEPORTS:
BBB9111111111111111
BBB1111111111111111
B111111111111111111
B111111111111111111
B111111111111111111
B111111111111111111
BB11111111111111111
1B11111111111111111
BB11111111111111111
A111111111111111111
1111111111111111111
1111111111111111111
1111111111111111111
1111111111111111111
1111111111111111111
