START:8,9
TOTAL_TILES:16
COIN_BAGS:
KEYS:
BLOCKS:
TELEPORTS:
1111111111111111111
1111111111111111111
1111111111111111111
1111111111111111111
111111111BBBBB11111
11111111BB9BBB11111
11111111B11BB111111
11111111B1111111111
11111111B1111111111
11111111A1111111111
1111111111111111111
1111111111111111111
1111111111111111111
1111111111111111111
1111111111111111111
