START:10,3
TOTAL_TILES:16
COIN_BAGS:
KEYS:
BLOCKS:
TELEPORTS:
1111111111111111111
1111111111111111111
1111111111111111111
1111111111AB1111111
11111111111BB111111
111111111111BB11111
1111111111111BB1111
1111111111111BB1111
1111111111111B11111
111111111111BB11111
111111111111BBB1111
1111111111111191111
1111111111111111111
1111111111111111111
1111111111111111111
