START:3,2
TOTAL_TILES:16
COIN_BAGS:
KEYS:
BLOCKS:
TELEPORTS:
1111111111111111111
1111111111111111111
111A111111111111111
111B111111111111111
111B111111111111111
111B111111111111111
11BB111111111111111
11BBBB1111111111111
11111B1111111111111
11111B1111111111111
11111BB911111111111
111111BB11111111111
1111111111111111111
1111111111111111111
1111111111111111111
