START:3,4
TOTAL_TILES:16
COIN_BAGS:
KEYS:
BLOCKS:
TELEPORTS:
1111111111111111111
1111111111111111111
1111111111111111111
1111111111111111111
111ABBB111111111111
111111B111111111111
11111BB111111111111
11111B1111111111111
11111BBBB1111111111
1111119BB1111111111
111111BB11111111111
1111111111111111111
1111111111111111111
1111111111111111111
1111111111111111111
