START:14,12
TOTAL_TILES:15
COIN_BAGS:
KEYS:
BLOCKS:
TELEPORTS:
1111111111111111111
1111111111111111111
1111111111111111111
1111111111111111111
1111111111111111111
1111111111111111111
1111111111111111111
1111111111111111111
1111111111111111111
11111111111111BBB11
11111111111111BBB11
1111111111111BBB111
11111111111119AB111
11111111111111BB111
11111111111111BB111
