START:9,5
TOTAL_TILES:16
COIN_BAGS:
KEYS:
BLOCKS:
TELEPORTS:
1111111111111111111
1111111111111119111
111111111111BBBB111
111111111111B111111
111111111111B111111
111111111A1BB111111
11111111BB1B1111111
11111111BBBB1111111
1111111111111111111
1111111111111111111
1111111111111111111
1111111111111111111
1111111111111111111
1111111111111111111
1111111111111111111
