START:14,6
TOTAL_TILES:16
COIN_BAGS:
KEYS:
BLOCKS:
TELEPORTS:
1111111111111111111
1111111111111111111
1111111111111111111
1111111111111111111
111111111111111BBB1
11111111111111BBBB1
11111111111111A1B11
1111111111111111B11
1111111111111111B11
11111111111119BBB11
11111111111111BB111
1111111111111111111
1111111111111111111
1111111111111111111
1111111111111111111
