START:16,3
TOTAL_TILES:16
COIN_BAGS:
KEYS:
BLOCKS:
TELEPORTS:
1111111111111111111
1111111111111111111
11111111111111111BB
1111111111111111ABB
111111111111111111B
111111111111111111B
111111111111111111B
1111111111111111BBB
1111111111111111B11
1111111111111111B11
1111111111111111BB1
11111111111111119B1
1111111111111111111
1111111111111111111
1111111111111111111
