START:13,2
TOTAL_TILES:16
COIN_BAGS:
KEYS:
BLOCKS:
TELEPORTS:
1111111111111111111
111111111111111BBB1
1111111111111ABBBB1
1111111111111111B11
1111111111111111B11
111111111111111BB11
111111111111111BB11
1111111111111111B11
1111111111111111B91
1111111111111111111
1111111111111111111
1111111111111111111
1111111111111111111
1111111111111111111
1111111111111111111
