START:10,8
TOTAL_TILES:16
COIN_BAGS:
KEYS:
BLOCKS:
TELEPORTS:
1111111111111111111
1111111111111111111
1111111111111111111
1111111111111111111
1111111111111111111
1111111111111111111
1111111111111111111
1111111111111111111
111111111BA11111111
111111111BBB1111111
11111111BBBBB111111
11111111BBB1BB11111
1111111111111B11111
1111111111111911111
1111111111111111111
