START:6,1
TOTAL_TILES:14
COIN_BAGS:
KEYS:
BLOCKS:
TELEPORTS:
11111BBB11111111111
11111BAB11111111111
111111BB11111111111
111B9BB111111111111
111BBB1111111111111
1111111111111111111
1111111111111111111
1111111111111111111
1111111111111111111
1111111111111111111
1111111111111111111
1111111111111111111
1111111111111111111
1111111111111111111
1111111111111111111
