START:18,13
TOTAL_TILES:16
COIN_BAGS:
KEYS:
BLOCKS:
TELEPORTS:
1111111111111111111
1111111111111111111
1111111111111111111
1111111111111111111
1111111111111111111
1111111111111111BB9
1111111111111111BBB
1111111111111111BBB
1111111111111111B11
1111111111111111BB1
11111111111111111BB
111111111111111111B
111111111111111111B
111111111111111111A
1111111111111111111
