START:4,1
TOTAL_TILES:16
COIN_BAGS:
KEYS:
BLOCKS:
TELEPORTS:
1111111111111111111
111BA11111111111111
111BBB1111111111111
11BBBB1111111111111
11B1BB1111111111111
1BB1111111111111111
BB11111111111111111
9111111111111111111
1111111111111111111
1111111111111111111
1111111111111111111
1111111111111111111
1111111111111111111
1111111111111111111
1111111111111111111
