START:14,5
TOTAL_TILES:16
COIN_BAGS:
KEYS:
BLOCKS:
TELEPORTS:
1111111111111111111
1111111111111111111
1111111111111111111
1111111111111111111
1111111111111111111
1111111111111BA1111
1111111111111B11111
111111111111BB11111
11111111111BB111111
1111111111BB1111111
1111111111BB1111111
11111111111B1111111
1111111111BB1111111
1111111111BB1111111
1111111111191111111
