START:14,1
TOTAL_TILES:16
COIN_BAGS:
KEYS:
BLOCKS:
TELEPORTS:
1111111111111BBBB11
1111111111111BABB11
111111111111111B111
111111111111111B111
111111111111111B111
111111111111111BBB1
1111111111111119BB1
1111111111111111111
1111111111111111111
1111111111111111111
1111111111111111111
1111111111111111111
1111111111111111111
1111111111111111111
1111111111111111111
