START:4,6
TOTAL_TILES:16
COIN_BAGS:
KEYS:
BLOCKS:
TELEPORTS:
111111BBB1111111111
111111BBB1111111111
111111BB11111111111
111111BBB9111111111
111111B111111111111
1111BBB111111111111
1111A11111111111111
1111111111111111111
1111111111111111111
1111111111111111111
1111111111111111111
1111111111111111111
1111111111111111111
1111111111111111111
1111111111111111111
