START:11,0
TOTAL_TILES:16
COIN_BAGS:
KEYS:
BLOCKS:
TELEPORTS:
11111111111A1111111
1111111111BB1111111
1111111111B11111111
1111111111B11111111
1111111111BBB111111
1111111111BBB111111
111111111111B111111
111111111111BBBB911
1111111111111111111
1111111111111111111
1111111111111111111
1111111111111111111
1111111111111111111
1111111111111111111
1111111111111111111
