START:17,2
TOTAL_TILES:16
COIN_BAGS:
KEYS:
BLOCKS:
TELEPORTS:
11111111111111111BB
11111111111111111BB
11111111111111111AB
11111111111111BB11B
11111111111119BB11B
111111111111111BBBB
1111111111111111111
1111111111111111111
1111111111111111111
1111111111111111111
1111111111111111111
1111111111111111111
1111111111111111111
1111111111111111111
1111111111111111111
