START:2,9
TOTAL_TILES:16
COIN_BAGS:
KEYS:
BLOCKS:
TELEPORTS:
1111111111111111111
1111111111111111111
1111111111111111111
1111111111111111111
1111111111111111111
1111111111111111111
1111111111111111111
1111111111111111111
1111111111111111111
1BA1111111111111111
1B11111111111111111
1BBBBB1111111111111
11111BBBB1111111111
11111111BBB11111111
1111111119B11111111
