START:11,7
TOTAL_TILES:16
COIN_BAGS:
KEYS:
BLOCKS:
TELEPORTS:
1111111111111111111
1111111111BB1111111
111111119BBB1111111
11111111BBBB1111111
11111111B1111111111
11111111BBB11111111
1111111111BB1111111
11111111111A1111111
1111111111111111111
1111111111111111111
1111111111111111111
1111111111111111111
1111111111111111111
1111111111111111111
1111111111111111111
