START:13,7
TOTAL_TILES:16
COIN_BAGS:
KEYS:
BLOCKS:
TELEPORTS:
1111111111111111111
1111111111111111111
1111111111111111111
1111111111111111111
1111111111111111111
1111111111111111111
1111111111111111111
1111111111111A11111
111111119B111B11111
11111111BB11BB11111
1111111BBBBBB111111
1111111BBB111111111
1111111111111111111
1111111111111111111
1111111111111111111
