START:12,9
TOTAL_TILES:16
COIN_BAGS:
KEYS:
BLOCKS:
TELEPORTS:
1111111111111111111
1111111111111111111
1111111111111111111
1111111111111111111
1111111111111111111
1111111111111111111
1111111111111111111
1111111111111111111
1111111111111111111
11111111BBBBA111111
11111111B1111111111
11111111BB111111111
111111111B111111111
1111119BBB111111111
111111BBBB111111111
