START:11,10
TOTAL_TILES:16
COIN_BAGS:
KEYS:
BLOCKS:
TELEPORTS:
1111111111111111111
1111111111111111111
1111111111111111111
1111111111111111111
1111111111111111111
1111111111111111111
1111111111111111111
1111BB9111111111111
1111BBB111111111111
1111BBBBBBB11111111
11111111BBBA1111111
1111111111111111111
1111111111111111111
1111111111111111111
1111111111111111111
