START:5,9
TOTAL_TILES:16
COIN_BAGS:
KEYS:
BLOCKS:
TELEPORTS:
1111111111111111111
1111111111111111111
1111111111111111111
1111111111111111111
1111111111111111111
1111111111111111111
1111111111111111111
1111111111111111111
1111111111111111111
11BB1A1111111111111
11BBBB1111111111111
11BBBBB111111111111
119BBBB111111111111
1111111111111111111
1111111111111111111
