START:13,4
TOTAL_TILES:16
COIN_BAGS:
KEYS:
BLOCKS:
TELEPORTS:
111111BBB9111111111
111111BBBB111111111
1111111BB1111111111
11111111BBBB1111111
11111111111BBA11111
1111111111111111111
1111111111111111111
1111111111111111111
1111111111111111111
1111111111111111111
1111111111111111111
1111111111111111111
1111111111111111111
1111111111111111111
1111111111111111111
