START:3,6
TOTAL_TILES:16
COIN_BAGS:
KEYS:
BLOCKS:
TELEPORTS:
1111111111111111111
1111111111111111111
1111111111111111111
1111111111111111111
1111111111111111111
1111111111111111111
111AB1BB11111111111
1111BBBB11111111111
1111111BB1111111111
111111BBB1111111111
111119B111111111111
11111BB111111111111
1111111111111111111
1111111111111111111
1111111111111111111
