START:11,0
TOTAL_TILES:16
COIN_BAGS:
KEYS:
BLOCKS:
TELEPORTS:
11111111111A1111111
11111111111B1111111
1111111111BBBB11111
1111111111BBBB11111
11111111BBBBBB11111
1111111191111111111
1111111111111111111
1111111111111111111
1111111111111111111
1111111111111111111
1111111111111111111
1111111111111111111
1111111111111111111
1111111111111111111
1111111111111111111
