START:12,12
TOTAL_TILES:16
COIN_BAGS:
KEYS:
BLOCKS:
TELEPORTS:
1111111111111111111
1111111111111111111
1111111111111111111
1111111111111111111
1111111111111111111
1111111111111111111
1111111111111111111
1111111111111111111
1111111111111111111
111111BB11111111111
1111119BB1111111111
11111111B1111111111
11111111B111A111111
1111111BB11BB111111
1111111BBBBB1111111
