START:13,10
TOTAL_TILES:16
COIN_BAGS:
KEYS:
BLOCKS:
TELEPORTS:
1111111111111111111
1111111111111111111
1111111111111111111
1111111111111111111
1111111111111111111
1111111111111111111
1111111111111111111
1111111111111111911
1111111111111111B11
1111111111111111B11
1111111111111A11B11
1111111111111BBBBB1
11111111111111BBBB1
11111111111111BBB11
1111111111111111111
