START:11,14
TOTAL_TILES:16
COIN_BAGS:
KEYS:
BLOCKS:
TELEPORTS:
1111111111111111111
1111111111111111111
1111111111111111111
1111111111111111111
1111111111111111111
1111111111111111111
1111111111111111111
1111111111111111111
1111111111111111111
9B11111111111111111
1BBB111111111111111
111BB11111111111111
1111B11111111111111
1111BB1111111111111
11111BBBBBBA1111111
