START:10,9
TOTAL_TILES:16
COIN_BAGS:
KEYS:
BLOCKS:
TELEPORTS:
1111111111111111111
1111111111111111111
1111111111111111111
1111111111111111111
1111111111111111111
1111111111111111111
1111111111111111111
11111BBBBB111111111
1111BB111BB11111111
1111BBBB11A11111111
1111111B11111111111
1111119B11111111111
1111111111111111111
1111111111111111111
1111111111111111111
