START:5,8
TOTAL_TILES:16
COIN_BAGS:
KEYS:
BLOCKS:
TELEPORTS:
1111111111111111111
1111111111111111111
1111111111111111111
1111111111111111111
1119B11111111111111
1111B11111111111111
11BBB11111111111111
11BBB11111111111111
11BBBA1111111111111
111BB11111111111111
111BB11111111111111
1111111111111111111
1111111111111111111
1111111111111111111
1111111111111111111
