START:5,1
TOTAL_TILES:16
COIN_BAGS:
KEYS:
BLOCKS:
TELEPORTS:
1111BB1111111111111
111BBA1111111111111
111B111111111111111
111BBB1111111111111
111BBB9111111111111
111BB11111111111111
111BB11111111111111
1111111111111111111
1111111111111111111
1111111111111111111
1111111111111111111
1111111111111111111
1111111111111111111
1111111111111111111
1111111111111111111
