START:4,12
TOTAL_TILES:16
COIN_BAGS:
KEYS:
BLOCKS:
TELEPORTS:
1111111111111111111
1111111111111111111
1111111111111111111
1111111111111111111
111B911111111111111
111BBB1111111111111
1111BB1111111111111
1111B11111111111111
1111B11111111111111
11BBB11111111111111
11BBB11111111111111
1111B11111111111111
1111A11111111111111
1111111111111111111
1111111111111111111
