START:5,12
TOTAL_TILES:16
COIN_BAGS:
KEYS:
BLOCKS:
TELEPORTS:
1111111111111111111
1111111111111111111
1111111111111111111
1111111111111111111
1111111111111111111
11111BBBB1111111111
11111BBBB9111111111
1111111B11111111111
1111111B11111111111
1111111B11111111111
1111111B11111111111
111111BB11111111111
11111AB111111111111
1111111111111111111
1111111111111111111
