START:15,2
TOTAL_TILES:16
COIN_BAGS:
KEYS:
BLOCKS:
TELEPORTS:
1111111111111111111
1111111111111111111
11111111BBBB11BA111
11111111BBBBBBB1111
11111111B1111111111
11111111B1111111111
11111111B1111111111
1111111191111111111
1111111111111111111
1111111111111111111
1111111111111111111
1111111111111111111
1111111111111111111
1111111111111111111
1111111111111111111
