START:5,13
TOTAL_TILES:16
COIN_BAGS:
KEYS:
BLOCKS:
TELEPORTS:
1111111111111111111
1111111111111111111
1111111111111111111
1111111111111111111
1111111111111111111
1111111111111111111
1111111111111111111
1111111111111111111
1111111111111111111
1111111111111111111
9111111111111111111
B111111111111111111
BBB11BB111111111111
BBB11AB111111111111
11BBBBB111111111111
