START:6,14
TOTAL_TILES:16
COIN_BAGS:
KEYS:
BLOCKS:
TELEPORTS:
1111111111111111111
1111111111111111111
1111111111111111111
1111111111111111111
1111111111111111111
1111111111111111111
1111111111111111111
1111111111111111111
1111111111111111111
111111111BB11111111
111111119BB11111111
1111111111B11111111
111111BB11B11111111
111111BB11B11111111
111111ABBBB11111111
