START:10,7
TOTAL_TILES:16
COIN_BAGS:
KEYS:
BLOCKS:
TELEPORTS:
1111111111111111111
1111111111111111111
1111111111111111111
1111111111111111111
1111111111111111111
11111111BBB11111111
11111111BBB11111111
111111111BA11111111
111111111BBB1111111
111111111BBB1111111
111111111BB11111111
1111111111911111111
1111111111111111111
1111111111111111111
1111111111111111111
