START:9,10
TOTAL_TILES:16
COIN_BAGS:
KEYS:
BLOCKS:
TELEPORTS:
1111111111111111111
1111111111111111111
1111111111111111111
1111111111111111111
1111111111111111111
1111111111111111111
1111111111111111111
1111111111111111111
111111111BB11119111
111111111BB1BB1BB11
111111111ABBBBBBB11
1111111111111111111
1111111111111111111
1111111111111111111
1111111111111111111
