START:1,11
TOTAL_TILES:16
COIN_BAGS:
KEYS:
BLOCKS:
TELEPORTS:
1111111111111111111
BBB9111111111111111
B111111111111111111
BB11111111111111111
BB11111111111111111
B111111111111111111
B111111111111111111
B111111111111111111
B111111111111111111
B111111111111111111
B111111111111111111
BA11111111111111111
1111111111111111111
1111111111111111111
1111111111111111111
