START:12,12
TOTAL_TILES:16
COIN_BAGS:
KEYS:
BLOCKS:
TELEPORTS:
1111111111111111111
1111111111111111111
1111111111111111111
1111111111111111111
1111111111111111111
1111111111111111111
1111111111111111111
1111111111111111111
11111111BBBBB111111
11111119B111B111111
111111111111B111111
111111111111BBB1111
111111111111ABB1111
111111111111BB11111
1111111111111111111
