START:4,1
TOTAL_TILES:16
COIN_BAGS:
KEYS:
BLOCKS:
TELEPORTS:
1111111BBBB11111111
1111A1BB1BB11111111
1111BBB11BB11111111
1111111111B11111111
1111111111B11111111
1111111111911111111
1111111111111111111
1111111111111111111
1111111111111111111
1111111111111111111
1111111111111111111
1111111111111111111
1111111111111111111
1111111111111111111
1111111111111111111
