START:11,9
TOTAL_TILES:16
COIN_BAGS:
KEYS:
BLOCKS:
TELEPORTS:
1111111111111111111
1111111111111111111
1111111111111111111
1111111111111111111
1111111111111111111
1111111111111111111
1111111111111111111
1111111111111111111
1111111111111111111
11111111111AB111111
11111111111BB111111
11111119BBBB1111111
1111111BBBBB1111111
111111111BBB1111111
1111111111111111111
