START:14,8
TOTAL_TILES:16
COIN_BAGS:
KEYS:
BLOCKS:
TELEPORTS:
1111111111111111111
1111111111111111111
1111111111111111111
1111111111111111111
1111111111111111111
1111111111111111111
1111111111111111111
1111111111111111111
11111111111111A1111
111111111111BBB1111
111111111111BBB1111
1111111119B1BBB1111
1111111111BBBBB1111
1111111111111111111
1111111111111111111
