START:4,8
TOTAL_TILES:16
COIN_BAGS:
KEYS:
BLOCKS:
TELEPORTS:
1111111111111111111
1111111111111111111
1111111111111111111
1111111111111111111
1111111111111111111
1111111111111111111
1111111111111111111
1111111111111111111
111BA11111111111111
111B111111111111111
111B1B9111111111111
111BBBBB11111111111
1111BBBB11111111111
111111BB11111111111
1111111111111111111
