START:9,4
TOTAL_TILES:16
COIN_BAGS:
KEYS:
BLOCKS:
TELEPORTS:
19BB111111111111111
111BB11111111111111
1111B11111111111111
1111B11111111111111
1111BBBBBA111111111
1111111BB1111111111
1111111BB1111111111
1111111111111111111
1111111111111111111
1111111111111111111
1111111111111111111
1111111111111111111
1111111111111111111
1111111111111111111
1111111111111111111
