START:4,11
TOTAL_TILES:16
COIN_BAGS:
KEYS:
BLOCKS:
TELEPORTS:
1111111111111111111
1111111111111111111
1111111111111111111
1111111111111111111
1111111111111111111
1111111111111111111
1111111911111111111
11111BBB11111111111
11111BBB11111111111
1111111BB1111111111
1111BB1BB1111111111
1111ABBB11111111111
1111111111111111111
1111111111111111111
1111111111111111111
