START:9,11
TOTAL_TILES:16
COIN_BAGS:
KEYS:
BLOCKS:
TELEPORTS:
1111111111111111111
1111111111111111111
1111111111111111111
1111111111111111111
1111111111111111111
1111111111111111111
1111111111111111111
1111111111111111111
1111111111111111111
1111111111111119111
111111111111111B111
111111111A1111BB111
111111111B1111B1111
111111111BBB11B1111
111111111BBBBBB1111
