START:7,10
TOTAL_TILES:16
COIN_BAGS:
KEYS:
BLOCKS:
TELEPORTS:
1111111111111111111
1111111111111111111
1111111111111111111
1111111111111111111
1111111111111111111
1111111111111111111
1111111111111111111
1111111111111111111
1111111111111111111
11111111BB111111111
1111111ABBBB1111111
111111111BBB1111111
111111111BBB1111111
111111111B111111111
11111119BB111111111
