START:6,13
TOTAL_TILES:16
COIN_BAGS:
KEYS:
BLOCKS:
TELEPORTS:
1111111111111111111
1111111111111111111
1111111111111111111
1111111111111111111
1111111111111111111
1111111111111111111
11111111B9111111111
11111111B1111111111
11111111BBB11111111
1111111111B11111111
1111111111B11111111
1111111111B11111111
1111111111B11111111
111111ABBBB11111111
11111111BB111111111
