START:10,1
TOTAL_TILES:15
COIN_BAGS:
KEYS:
BLOCKS:
TELEPORTS:
11119BBBBBBB1111111
11111111BBAB1111111
11111111BBBB1111111
1111111111111111111
1111111111111111111
1111111111111111111
1111111111111111111
1111111111111111111
1111111111111111111
1111111111111111111
1111111111111111111
1111111111111111111
1111111111111111111
1111111111111111111
1111111111111111111
