START:9,9
TOTAL_TILES:16
COIN_BAGS:
KEYS:
BLOCKS:
TELEPORTS:
1111111111111111111
1111111111111111111
1111111111111111111
1111111111111111111
1111111111111111111
1111111111111111111
1111111111111111111
11111BBBBB111111111
11111BB11BB11111111
1119BBB11AB11111111
1111BB1111111111111
1111111111111111111
1111111111111111111
1111111111111111111
1111111111111111111
