START:11,6
TOTAL_TILES:16
COIN_BAGS:
KEYS:
BLOCKS:
TELEPORTS:
1111111111111111111
1111111111111111111
1111111111111111111
1111111111111111111
1111111111111111111
1111111111111111111
111111111BBA1111111
111111111B111111111
111111111B111111111
111111111BB11111111
1111111111B11111111
1111111111B11111111
11111111B9BB1111111
11111111BBBB1111111
1111111111111111111
