START:9,0
TOTAL_TILES:16
COIN_BAGS:
KEYS:
BLOCKS:
TELEPORTS:
1111BBBBBA111111111
11BBB11111111111111
11BB111111111111111
111B111111111111111
111B111111111111111
111B111111111111111
11BB111111111111111
1191111111111111111
1111111111111111111
1111111111111111111
1111111111111111111
1111111111111111111
1111111111111111111
1111111111111111111
1111111111111111111
