START:5,10
TOTAL_TILES:16
COIN_BAGS:
KEYS:
BLOCKS:
TELEPORTS:
1111111111111111111
1111111111111111111
1111111111111111111
1111111111111111111
1111111111111111111
1111111111111111111
1111111111111111111
1111111111111111111
1111111111111111111
11BBBBBBBBBB1111111
11BBBA1119BB1111111
1111111111111111111
1111111111111111111
1111111111111111111
1111111111111111111
