START:5,7
TOTAL_TILES:16
COIN_BAGS:
KEYS:
BLOCKS:
TELEPORTS:
1111111111111111111
1111111111111111111
1111111111111111111
1111111111111111111
1111111111111111111
1111111111111111111
1111111111111111111
11111AB111111111111
111111BBB1111111111
11111111B1111111111
11111111B1111111111
11111111B1111111111
1111111BB1111111111
1111111B11111111111
119BBBBB11111111111
