START:6,8
TOTAL_TILES:16
COIN_BAGS:
KEYS:
BLOCKS:
TELEPORTS:
1111111111111111111
1111111111111111111
1111111111111111111
1111111111111111111
1111111111111111111
1111111111111111111
1111111111111111111
1111111111111111111
111111A111111111111
111111BBB1111111111
11111BB1B1111111111
111BBBBBB1111111111
1BBB111111111111111
1911111111111111111
1111111111111111111
