START:1,1
TOTAL_TILES:16
COIN_BAGS:
KEYS:
BLOCKS:
TELEPORTS:
11BBB11111111111111
1AB1B11111111111111
111BB11111111111111
111BB11111111111111
1BBBB11111111111111
1BB1111111111111111
1191111111111111111
1111111111111111111
1111111111111111111
1111111111111111111
1111111111111111111
1111111111111111111
1111111111111111111
1111111111111111111
1111111111111111111
