START:14,1
TOTAL_TILES:16
COIN_BAGS:
KEYS:
BLOCKS:
TELEPORTS:
1111111111111111111
11111111111111A1111
11111111111111BB111
111111111111111B111
111111111111111B111
111111111111111B111
111111111111BBBB111
111111111111BB1B911
1111111111111BBB111
1111111111111111111
1111111111111111111
1111111111111111111
1111111111111111111
1111111111111111111
1111111111111111111
