START:5,13
TOTAL_TILES:16
COIN_BAGS:
KEYS:
BLOCKS:
TELEPORTS:
1111111111111111111
1111111111111111111
1111111111111111111
1111111111111111111
1111111111111111111
1111111111111111111
1111111111111111111
1111111111111111111
1111111111111111111
BB11111111111111111
9B11111111111111111
1B11111111111111111
1BB1111111111111111
1BB11AB111111111111
1BBBBBB111111111111
