START:2,8
TOTAL_TILES:16
COIN_BAGS:
KEYS:
BLOCKS:
TELEPORTS:
1111111111111111111
1111111111111111111
1111111111111111111
111119BB11111111111
11111BBB11111111111
11111BBB11111111111
1111BBBB11111111111
111BB11111111111111
11AB111111111111111
1111111111111111111
1111111111111111111
1111111111111111111
1111111111111111111
1111111111111111111
1111111111111111111
