START:6,3
TOTAL_TILES:16
COIN_BAGS:
KEYS:
BLOCKS:
TELEPORTS:
1111111111111111111
1111111111111111111
1111111111111111111
11111BA111111111111
11111BB111111111111
11111BB111111111111
11111BB111111111111
1111BBB111111111111
111BBBB111111111111
111B911111111111111
1111111111111111111
1111111111111111111
1111111111111111111
1111111111111111111
1111111111111111111
