START:16,10
TOTAL_TILES:16
COIN_BAGS:
KEYS:
BLOCKS:
TELEPORTS:
1111111111111111111
1111111111111111111
1111111111111111111
1111111111111111111
1111111111111111111
1111111911111111111
1111111BB1111111111
11111111BBB11111111
1111111111B11111111
111111111BB11111111
111111111BBBBBBBA11
1111111111111111111
1111111111111111111
1111111111111111111
1111111111111111111
