START:5,6
TOTAL_TILES:16
COIN_BAGS:
KEYS:
BLOCKS:
TELEPORTS:
11BBB91111111111111
11BBBB1111111111111
111BBB1111111111111
11111B1111111111111
11111BB111111111111
11111BB111111111111
11111A1111111111111
1111111111111111111
1111111111111111111
1111111111111111111
1111111111111111111
1111111111111111111
1111111111111111111
1111111111111111111
1111111111111111111
