START:17,6
TOTAL_TILES:16
COIN_BAGS:
KEYS:
BLOCKS:
TELEPORTS:
1111111111111111111
1111111111111111111
1111111111111111111
1111111111111111111
1111111111111111111
1111111111111111111
11111111111111111A1
11111111111111111B1
11111111111111111B1
11111111111111111B1
11111111111111111B1
111111111111119B1B1
11111111111111BB1B1
11111111111111BB1B1
111111111111111BBB1
