START:1,8
TOTAL_TILES:16
COIN_BAGS:
KEYS:
BLOCKS:
TELEPORTS:
1111111111111111111
1111111111111111111
1111111111111111111
1111111111111111111
1111111111111111111
1111111111111111111
1111111111111111111
1191111111111111111
BABB111111111111111
BBBBBB1111111111111
BBBBBB1111111111111
1111111111111111111
1111111111111111111
1111111111111111111
1111111111111111111
