START:10,6
TOTAL_TILES:16
COIN_BAGS:
KEYS:
BLOCKS:
TELEPORTS:
111111111111BB11111
111111111119BB11111
111111111111BB11111
111111111111B111111
111111111111B111111
111111111111B111111
1111111111ABBB11111
11111111111BBB11111
1111111111111111111
1111111111111111111
1111111111111111111
1111111111111111111
1111111111111111111
1111111111111111111
1111111111111111111
