START:10,3
TOTAL_TILES:16
COIN_BAGS:
KEYS:
BLOCKS:
TELEPORTS:
1111111111111111111
1111111111111111111
1111111111111111111
1111111111A11111111
11111111BBB11111111
11111111BB111111111
111111111BBB1111111
111111111BBBBBB1111
11111111111119B1111
1111111111111111111
1111111111111111111
1111111111111111111
1111111111111111111
1111111111111111111
1111111111111111111
