START:9,8
TOTAL_TILES:16
COIN_BAGS:
KEYS:
BLOCKS:
TELEPORTS:
1111111111111111111
1111111111111111111
1111111111111111111
1111111111111111111
1111111111111111111
1111111111111111111
111111BBB1111111111
111111B191111111111
11111BBBBA111111111
11111B1B11111111111
11111B1B11111111111
11111BBB11111111111
1111111111111111111
1111111111111111111
1111111111111111111
