START:15,6
TOTAL_TILES:16
COIN_BAGS:
KEYS:
BLOCKS:
TELEPORTS:
1111111111111119B11
1111111111111111BB1
11111111111111111B1
11111111111111111B1
11111111111111111B1
1111111111111111BB1
11111111111111BAB11
11111111111111BBB11
111111111111111BB11
1111111111111111111
1111111111111111111
1111111111111111111
1111111111111111111
1111111111111111111
1111111111111111111
