START:3,9
TOTAL_TILES:16
COIN_BAGS:
KEYS:
BLOCKS:
TELEPORTS:
1111111111111111111
1111111111111111111
BB11111111111111111
BB11111111111111111
9BB1111111111111111
11B1111111111111111
11B1111111111111111
11B1111111111111111
BBB1111111111111111
BBBA111111111111111
1111111111111111111
1111111111111111111
1111111111111111111
1111111111111111111
1111111111111111111
