START:15,3
TOTAL_TILES:16
COIN_BAGS:
KEYS:
BLOCKS:
TELEPORTS:
1111111111111111111
1111111111111111111
1111111111111111111
11111111111111BA111
11111111111111B1111
1111111111111BB1111
1111111111111BB1111
11111111111111BBB11
11111111111111BBB11
11111111111111BB111
111111111111111B111
1111111111111119111
1111111111111111111
1111111111111111111
1111111111111111111
