START:10,13
TOTAL_TILES:16
COIN_BAGS:
KEYS:
BLOCKS:
TELEPORTS:
1111111111111111111
1111111111111111111
1111111111111111111
1111111111111111111
1111111111111111111
1111111111111111111
111111BBB9111111111
111111B111111111111
111111B111111111111
111111B111111111111
111111B111111111111
111111B111111111111
111111B111111111111
111111BB11A11111111
1111111BBBB11111111
