START:0,1
TOTAL_TILES:16
COIN_BAGS:
KEYS:
BLOCKS:
TELEPORTS:
1111111111111111111
A111111111111111111
B111111111111111111
B111111111111111111
BBB1111111111111111
11BBBBBB11111111111
11111BB911111111111
11111BB111111111111
1111111111111111111
1111111111111111111
1111111111111111111
1111111111111111111
1111111111111111111
1111111111111111111
1111111111111111111
