START:0,8
TOTAL_TILES:16
COIN_BAGS:
KEYS:
BLOCKS:
TELEPORTS:
1111111111111111111
1111111111111111111
BBBB111111111111111
B11B111111111111111
B1BB111111111111111
B1B9111111111111111
BB11111111111111111
BB11111111111111111
A111111111111111111
1111111111111111111
1111111111111111111
1111111111111111111
1111111111111111111
1111111111111111111
1111111111111111111
