START:5,2
TOTAL_TILES:16
COIN_BAGS:
KEYS:
BLOCKS:
TELEPORTS:
1111BBB111111111111
1111BBB111111111111
111BBA1111111111111
111B111111111111111
111B111111111111111
11BB911111111111111
11BBB11111111111111
1111111111111111111
1111111111111111111
1111111111111111111
1111111111111111111
1111111111111111111
1111111111111111111
1111111111111111111
1111111111111111111
