START:11,12
TOTAL_TILES:16
COIN_BAGS:
KEYS:
BLOCKS:
TELEPORTS:
1111111111111111111
1111111111111111111
1111111111111111111
1111111111111111111
1111111111111111111
1111111111111111911
111111111111BBBBB11
111111111111B11BB11
11111111111BB111111
11111111111BB111111
111111111111B111111
11111111111BB111111
11111111111A1111111
1111111111111111111
1111111111111111111
