START:14,7
TOTAL_TILES:16
COIN_BAGS:
KEYS:
BLOCKS:
TELEPORTS:
1111111111111119B11
1111111111111111B11
1111111111111111BB1
11111111111111111BB
11111111111111111BB
11111111111111111B1
11111111111111BBBB1
11111111111111A1BB1
1111111111111111111
1111111111111111111
1111111111111111111
1111111111111111111
1111111111111111111
1111111111111111111
1111111111111111111
