START:17,5
TOTAL_TILES:16
COIN_BAGS:
KEYS:
BLOCKS:
TELEPORTS:
1111111111111111111
1111111111111111111
1111111111111111111
1111111111111111111
1111111111111111111
11111111111111111AB
11111111111111111BB
11111111111111111BB
111111111111111111B
111111111111111BB1B
111111111111111B91B
111111111111111BBBB
1111111111111111111
1111111111111111111
1111111111111111111
