START:3,2
TOTAL_TILES:16
COIN_BAGS:
KEYS:
BLOCKS:
TELEPORTS:
1111111111111111111
1111111111111111111
111A111111111111111
111B111111111111111
1BBB111111111111111
1BBBB11111111111111
1BB1B11111111111111
1111B11111111111111
1111B11111111111111
119BB11111111111111
1111111111111111111
1111111111111111111
1111111111111111111
1111111111111111111
1111111111111111111
