START:2,8
TOTAL_TILES:16
COIN_BAGS:
KEYS:
BLOCKS:
TELEPORTS:
1191111111111111111
BBB1111111111111111
BB11111111111111111
1B11111111111111111
BB11111111111111111
BB11111111111111111
BB11111111111111111
BBB1111111111111111
11A1111111111111111
1111111111111111111
1111111111111111111
1111111111111111111
1111111111111111111
1111111111111111111
1111111111111111111
