START:7,10
TOTAL_TILES:16
COIN_BAGS:
KEYS:
BLOCKS:
TELEPORTS:
1111111111111111111
1111111111111111111
1111111111111111111
1111111111111111111
1111111111111111111
1111111111111111111
1111111111111111111
111111BBB1111111111
111111BBB1111111111
111111BBBB119111111
111111BA1BBBB111111
1111111111111111111
1111111111111111111
1111111111111111111
1111111111111111111
