START:16,9
TOTAL_TILES:16
COIN_BAGS:
KEYS:
BLOCKS:
TELEPORTS:
1111111111111111111
1111111111111111111
1111111111111111111
1111111111111111111
1111111111111111111
1111111111111111111
1111111111111111111
1111111111111111BB1
1111111111111111BBB
1111111111111111A1B
111111111111111111B
111111111111119BBBB
11111111111111111BB
11111111111111111BB
1111111111111111111
