START:9,13
TOTAL_TILES:16
COIN_BAGS:
KEYS:
BLOCKS:
TELEPORTS:
1111111111111111111
1111111111111111111
1111111111111111111
1111111111111111111
1111111111111111111
1111111911111111111
1111111B11111111111
1111111BB1111111111
11111111BBB11111111
11111111BBB11111111
11111111B1111111111
11111111B1111111111
11111111BBB11111111
111111111AB11111111
1111111111111111111
