START:13,13
TOTAL_TILES:16
COIN_BAGS:
KEYS:
BLOCKS:
TELEPORTS:
1111111111111111111
1111111111111111111
1111111111111111111
1111111111111111111
1111111111111111111
1111111111111111111
1111111111111111111
1111111111111111111
1111111111911111111
1111111111B11111111
1111111111BBB111111
111111111111B111111
11111111111BB111111
111111111BBBBA11111
111111111BBBB111111
