START:11,3
TOTAL_TILES:16
COIN_BAGS:
KEYS:
BLOCKS:
TELEPORTS:
1111111111111111111
1111111111111111111
1111111111111111111
1111111111BA1111111
1111111111BB1111111
111111111BBB1111111
1111111BBBBB1111111
11111BBB11111111111
11111B9111111111111
1111111111111111111
1111111111111111111
1111111111111111111
1111111111111111111
1111111111111111111
1111111111111111111
