START:5,13
TOTAL_TILES:16
COIN_BAGS:
KEYS:
BLOCKS:
TELEPORTS:
1111111111111111111
1111111111111111111
1111111111111111111
1111111111111111111
1111111111111111111
1111111111111111111
1111111111111111111
1111111111111111111
1111111111111111111
1111BB1111111111111
1111BB1111111111111
111BBBBBB1111111111
111BB1BB91111111111
1111BA1111111111111
1111111111111111111
