START:4,6
TOTAL_TILES:16
COIN_BAGS:
KEYS:
BLOCKS:
TELEPORTS:
1111111111119111111
1111111BBBBBB111111
111111BB11BB1111111
111111B111111111111
1111BBB111111111111
1111B11111111111111
1111A11111111111111
1111111111111111111
1111111111111111111
1111111111111111111
1111111111111111111
1111111111111111111
1111111111111111111
1111111111111111111
1111111111111111111
