START:18,8
TOTAL_TILES:16
COIN_BAGS:
KEYS:
BLOCKS:
TELEPORTS:
1111111111111111111
1111111111111111111
1111111111111111111
111111111111111BBB1
111111111111111B1BB
111111111111111BB9B
1111111111111111BBB
1111111111111111BBB
111111111111111111A
1111111111111111111
1111111111111111111
1111111111111111111
1111111111111111111
1111111111111111111
1111111111111111111
