START:13,4
TOTAL_TILES:16
COIN_BAGS:
KEYS:
BLOCKS:
TELEPORTS:
11111111111111111BB
11111111111111111BB
1111111111111111BBB
11111111111111BBB1B
1111111111111AB1BBB
1111111111111111911
1111111111111111111
1111111111111111111
1111111111111111111
1111111111111111111
1111111111111111111
1111111111111111111
1111111111111111111
1111111111111111111
1111111111111111111
