START:8,10
TOTAL_TILES:16
COIN_BAGS:
KEYS:
BLOCKS:
TELEPORTS:
1111111111111111111
1111111111111111111
1111111111111111111
1111111111111111111
1111111111111111111
1111111111111111111
1111111111111111111
1111111111111111111
111111111BB11111111
11111111BBB119B1111
11111111A1B1BBB1111
1111111111BBBBB1111
1111111111111111111
1111111111111111111
1111111111111111111
