START:8,10
TOTAL_TILES:16
COIN_BAGS:
KEYS:
BLOCKS:
TELEPORTS:
1111111111111111111
1111111111111111111
1111111111111111111
1111111111111111111
1111111111111111111
1111111111111111111
1111111111111111111
1111111111111111111
1111111BBBB11111111
1111111BBBB11111111
11111111AB911111111
11111111BBB11111111
11111111BBB11111111
1111111111111111111
1111111111111111111
