START:10,14
TOTAL_TILES:16
COIN_BAGS:
KEYS:
BLOCKS:
TELEPORTS:
1111111111111111111
1111111111111111111
1111111111111111111
1111111111111111111
1111111111111111111
1111111111111111111
1111111111BB9111111
11111111BBB11111111
11111111BB111111111
111111111B111111111
111111111BB11111111
111111111BB11111111
111111111BB11111111
1111111111B11111111
1111111111A11111111
