START:5,11
TOTAL_TILES:16
COIN_BAGS:
KEYS:
BLOCKS:
TELEPORTS:
1111111111111111111
1111111111111111111
1111111111111111111
1111111111111111111
1111111111111111111
19BB111111111111111
111B111111111111111
11BB111111111111111
11BBBB1111111111111
111BBB1111111111111
111BBB1111111111111
11111A1111111111111
1111111111111111111
1111111111111111111
1111111111111111111
