START:15,4
TOTAL_TILES:16
COIN_BAGS:
KEYS:
BLOCKS:
TELEPORTS:
1111111111111111111
1111111111111111111
1111111111111111111
1111111111111111111
111111111111111ABBB
111111111111111111B
111111111111111111B
111111111111111111B
111111111111111111B
111111111111111111B
111111111111111111B
111111111111111111B
11111111111111191BB
111111111111111BBB1
1111111111111111111
