START:14,9
TOTAL_TILES:16
COIN_BAGS:
KEYS:
BLOCKS:
TELEPORTS:
1111111111111111111
1111111111111111111
1111111111111111111
1111111111111111111
1111111111111111111
1111111111111111111
1111111111111111111
1111111111111111111
1111111111111111111
11111111111111A1111
111111111111BBB1111
11111111111BB111111
1111111111BB1111111
111111119BBBB111111
111111111BBBB111111
