START:11,6
TOTAL_TILES:16
COIN_BAGS:
KEYS:
BLOCKS:
TELEPORTS:
1111111111111111111
1111111111111111111
1111111111111111111
1111111111111111111
1111111111111111111
1111111111111111111
11111111111AB111111
111111111111BB11111
11111111111BBB19111
11111111111BB11B111
111111111111BB1B111
1111111111111BBB111
1111111111111111111
1111111111111111111
1111111111111111111
