START:5,9
TOTAL_TILES:16
COIN_BAGS:
KEYS:
BLOCKS:
TELEPORTS:
1111111111111111111
1111111111111111111
1111111111111111111
1111111111111111111
1111111111111111111
1111111111111111111
1111111111111111111
1111111111111111111
BBB1111111111111111
BBB9BA1111111111111
BBBBB11111111111111
BBB1111111111111111
1111111111111111111
1111111111111111111
1111111111111111111
