START:10,7
TOTAL_TILES:16
COIN_BAGS:
KEYS:
BLOCKS:
TELEPORTS:
111111111BBBBB11111
111111111B119B11111
111111111B111111111
111111111B111111111
111111111BB11111111
111111111BB11111111
111111111B111111111
111111111BA11111111
1111111111111111111
1111111111111111111
1111111111111111111
1111111111111111111
1111111111111111111
1111111111111111111
1111111111111111111
