START:16,6
TOTAL_TILES:16
COIN_BAGS:
KEYS:
BLOCKS:
TELEPORTS:
1111111111111111111
1111111111111111111
1111111111111111111
1111111111111111111
1111111111111111111
1111111111111111111
111111111111111BA11
11111111111111BB111
11111111111111B1111
11111111111111B1111
1111111111111BB1111
1111111111111B11111
111111111111BB91111
111111111111BBB1111
111111111111BB11111
