START:16,10
TOTAL_TILES:16
COIN_BAGS:
KEYS:
BLOCKS:
TELEPORTS:
1111111111111111111
1111111111111111111
1111111111111111111
1111111111111111111
1111111111111111111
111111111111BBB1111
111111111111B1BB111
111111111111BBBB111
1111111111111BBB111
111111111111191BB11
1111111111111111A11
1111111111111111111
1111111111111111111
1111111111111111111
1111111111111111111
