START:3,6
TOTAL_TILES:16
COIN_BAGS:
KEYS:
BLOCKS:
TELEPORTS:
1111111111111111111
1111111111111111111
1111111111111111111
9BB1111111111111111
BBB1111111111111111
BBB1111111111111111
BBBAB11111111111111
11BBB11111111111111
1111111111111111111
1111111111111111111
1111111111111111111
1111111111111111111
1111111111111111111
1111111111111111111
1111111111111111111
