START:10,4
TOTAL_TILES:16
COIN_BAGS:
KEYS:
BLOCKS:
TELEPORTS:
1111111111111111111
1111111111111111111
1111111111111111111
1111111111111111111
111111111BA11111111
11111111BB111111111
11111111B1111111111
11111111B1111111111
11111111B1111111111
1111111BB1111111111
1111111BBBB11111111
1111111BB9B11111111
1111111111111111111
1111111111111111111
1111111111111111111
