START:7,12
TOTAL_TILES:16
COIN_BAGS:
KEYS:
BLOCKS:
TELEPORTS:
1111111111111111111
1111111111111111111
1111111111111111111
1111111111111111111
1111111111111111111
1111111111111111111
1111111111BB1111111
11111111119B1111111
1111111111BB1111111
1111111111B11111111
111111BBBBB11111111
111111BBB1111111111
1111111AB1111111111
1111111111111111111
1111111111111111111
