START:13,6
TOTAL_TILES:16
COIN_BAGS:
KEYS:
BLOCKS:
TELEPORTS:
1111111111111111111
1111111111111111111
1111111111111111111
1111111111111111111
1111111111111111111
11111111111BB111111
111111111BBBBA11111
111111111BBB1111111
11111111111BB111111
11111111111BB111111
1111111111BB1111111
1111111111911111111
1111111111111111111
1111111111111111111
1111111111111111111
