START:17,10
TOTAL_TILES:16
COIN_BAGS:
KEYS:
BLOCKS:
TELEPORTS:
1111111111111111111
1111111111111111111
1111111111111111111
1111111111119BB1111
11111111111111BB111
11111111111111BB111
11111111111111BB111
111111111111111BBB1
11111111111111111BB
11111111111111111BB
11111111111111111A1
1111111111111111111
1111111111111111111
1111111111111111111
1111111111111111111
