START:7,5
TOTAL_TILES:16
COIN_BAGS:
KEYS:
BLOCKS:
TELEPORTS:
1111111111111111111
1111111111111111111
11BB111111111111111
11BB111111111111111
11BBBBBB11111111111
11B1111A11111111111
11BB111111111111111
11BB111111111111111
1191111111111111111
1111111111111111111
1111111111111111111
1111111111111111111
1111111111111111111
1111111111111111111
1111111111111111111
