START:7,12
TOTAL_TILES:16
COIN_BAGS:
KEYS:
BLOCKS:
TELEPORTS:
1111111111111111111
1111111111111111111
1111111111111111111
1191111111111111111
11B1111111111111111
1BB1111111111111111
1B11111111111111111
1BB1111111111111111
11BB111111111111111
111BBBB111111111111
111111B111111111111
111111BB11111111111
1111111A11111111111
1111111111111111111
1111111111111111111
