START:11,13
TOTAL_TILES:16
COIN_BAGS:
KEYS:
BLOCKS:
TELEPORTS:
1111111111111111111
1111111111111111111
1111111111111111111
1111111111111111111
1111111111111111111
1111111111111111111
1111111111111111111
1111111111111111111
1111111111111111911
11111111111BBB11B11
11111111111B1BBBB11
11111111111BB11BB11
111111111111B111111
11111111111AB111111
1111111111111111111
