START:15,5
TOTAL_TILES:16
COIN_BAGS:
KEYS:
BLOCKS:
TELEPORTS:
1111111111111111111
1111111111111111111
1111111111111111111
111111111111111BBB1
111111111111111B1B1
111111111111111A1B1
1111111111111111BB1
111111111111111BB11
11111111111111BB911
11111111111111BBB11
1111111111111111111
1111111111111111111
1111111111111111111
1111111111111111111
1111111111111111111
