START:9,12
TOTAL_TILES:16
COIN_BAGS:
KEYS:
BLOCKS:
TELEPORTS:
1111111111111111111
1111111111111111111
1111111111111111111
1111111111111111111
1111111111111111111
1111111111111111111
1111111111111111111
1111111111111111111
1111111111111111111
1111111111BBB111111
1111111111BBB119111
111111111BBBBB1B111
111111111A111BBB111
1111111111111111111
1111111111111111111
