START:18,12
TOTAL_TILES:16
COIN_BAGS:
KEYS:
BLOCKS:
TELEPORTS:
1111111111111111111
1111111111111111111
1111111111111111111
1111111111111111111
1111111111111111111
1111111111111111111
1111111111111111BBB
111111111111111BBBB
111111111111111B9BB
11111111111111111BB
11111111111111111BB
111111111111111111B
111111111111111111A
1111111111111111111
1111111111111111111
