START:7,6
TOTAL_TILES:16
COIN_BAGS:
KEYS:
BLOCKS:
TELEPORTS:
1111111111111111111
1111111111111111111
1111111111111111111
11111111BBB11111111
1111111BB1B11111111
1111111BBBB11111111
1111111ABBB11111111
1111111111B11111111
1111111119B11111111
1111111111111111111
1111111111111111111
1111111111111111111
1111111111111111111
1111111111111111111
1111111111111111111
