START:7,0
TOTAL_TILES:16
COIN_BAGS:
KEYS:
BLOCKS:
TELEPORTS:
1111111ABBB11111111
111111111BB11111111
111111111BB11111111
1111111111B1BB11111
1111111111B1B911111
1111111111BBB111111
1111111111111111111
1111111111111111111
1111111111111111111
1111111111111111111
1111111111111111111
1111111111111111111
1111111111111111111
1111111111111111111
1111111111111111111
