START:13,3
TOTAL_TILES:16
COIN_BAGS:
KEYS:
BLOCKS:
TELEPORTS:
1111111111111111111
1111111111111111111
1111111111111111111
11111111111BBA11111
1111111BBBBB1111111
1111111BBB111111111
11111111BB111111111
11111111B1111111111
11111111BB911111111
1111111111111111111
1111111111111111111
1111111111111111111
1111111111111111111
1111111111111111111
1111111111111111111
