START:4,9
TOTAL_TILES:16
COIN_BAGS:
KEYS:
BLOCKS:
TELEPORTS:
1111111111111111111
1111111111111111111
1111111111111111111
1111111111111111111
BB19111111111111111
BBBB111111111111111
BB11111111111111111
1B11111111111111111
BB11111111111111111
BBBBA11111111111111
1111111111111111111
1111111111111111111
1111111111111111111
1111111111111111111
1111111111111111111
