START:15,5
TOTAL_TILES:16
COIN_BAGS:
KEYS:
BLOCKS:
TELEPORTS:
1111111111111111111
1111111111111111111
1111111111111111111
111111111111111BBBB
11111111111111BB9BB
11111111111111BA1BB
11111111111111111BB
11111111111111111BB
1111111111111111111
1111111111111111111
1111111111111111111
1111111111111111111
1111111111111111111
1111111111111111111
1111111111111111111
