START:6,12
TOTAL_TILES:16
COIN_BAGS:
KEYS:
BLOCKS:
TELEPORTS:
1111111111111111111
1111111111111111111
1111111111111111111
1111111111111111111
1111111111111111111
1111111111111111111
1111111111111111111
11BB111111111111111
1BBBB11111111111111
1BBBB91111111111111
111BBB1111111111111
11111B1111111111111
11111BA111111111111
1111111111111111111
1111111111111111111
