START:1,8
TOTAL_TILES:16
COIN_BAGS:
KEYS:
BLOCKS:
TELEPORTS:
1111111111111111111
1111111111111111111
1111111111111111111
1111111111111111111
1111111111111111111
1111111111111111111
1111111111111111111
1111111111111111111
BA11111111111111111
B111111111111111111
B111111111111111111
BBBB111111111111111
BBBB111111111111111
BBB1111111111111111
19B1111111111111111
