START:10,9
TOTAL_TILES:16
COIN_BAGS:
KEYS:
BLOCKS:
TELEPORTS:
1111111111111111111
1111111111111111111
1111111111111111111
1111111111111111111
1111111111111111111
1111111111111111111
1111111111111111111
1111111111111111111
1111111111111111111
1111111111A11111111
1111111111BB1111111
11111111111B1111111
1111111111BB19B1111
111111111BB1BBB1111
111111111BBBB111111
