START:18,2
TOTAL_TILES:16
COIN_BAGS:
KEYS:
BLOCKS:
TELEPORTS:
1111111111111111111
1111111111111111111
111111111111111111A
111111111111111111B
1111111111111111BBB
1111111111111111BBB
111111111111111111B
11111111111111111BB
11111111111111111B9
11111111111111111BB
11111111111111111BB
1111111111111111111
1111111111111111111
1111111111111111111
1111111111111111111
