START:6,10
TOTAL_TILES:16
COIN_BAGS:
KEYS:
BLOCKS:
TELEPORTS:
1111111111111111111
1111111111111111111
1111111111111111111
1119B11111111111111
1111BBBBB1111111111
1111111BB1111111111
1111111B11111111111
111111BB11111111111
11111BB111111111111
11111BB111111111111
111111A111111111111
1111111111111111111
1111111111111111111
1111111111111111111
1111111111111111111
