START:12,10
TOTAL_TILES:16
COIN_BAGS:
KEYS:
BLOCKS:
TELEPORTS:
1111111111111111111
1111111111111111111
1111111111111111111
1111111111111111111
1111111111111111111
1111111111111911111
1111111111111BBB111
111111111111BBBB111
11111111111BB111111
11111111111B1111111
11111111111BA111111
11111111111BB111111
11111111111BB111111
1111111111111111111
1111111111111111111
