START:8,7
TOTAL_TILES:16
COIN_BAGS:
KEYS:
BLOCKS:
TELEPORTS:
1111111111111111111
1111111111111111111
1111111111111111111
1111111111111111111
1111111111111111111
1111111111111111111
1111111111111111111
11111111A1111111111
11111119B1111111111
111111BBB1111111111
111111B1B1111111111
111111BBBBB11111111
1111111BBBB11111111
1111111111111111111
1111111111111111111
