START:11,11
TOTAL_TILES:16
COIN_BAGS:
KEYS:
BLOCKS:
TELEPORTS:
1111111111111111111
1111111111111111111
1111111111111111111
1111111111111111111
1111111111111111111
1111111111111111111
1111111111111111111
1111111111111111111
1111111111111111111
11111111111BBBB1111
11111111111BBBBB911
11111111111A1BB1111
11111111111BBBB1111
1111111111111111111
1111111111111111111
