START:13,5
TOTAL_TILES:16
COIN_BAGS:
KEYS:
BLOCKS:
TELEPORTS:
11111111111BBB11111
1111111111BB1B11111
1111111111BB1B11111
11111111BBBB1B11111
1111111191111B11111
1111111111111A11111
1111111111111111111
1111111111111111111
1111111111111111111
1111111111111111111
1111111111111111111
1111111111111111111
1111111111111111111
1111111111111111111
1111111111111111111
