START:12,9
TOTAL_TILES:16
COIN_BAGS:
KEYS:
BLOCKS:
TELEPORTS:
1111111111111111111
1111111111111111111
1111111111111111111
1111111111111111111
1111111111111111111
1111111111111111111
1111111111111111111
1111111111111111111
1111111111111111111
111111111111AB11111
1111111111111B11111
1111111111111BB1111
111111111111BBB1111
111111111111B1111B9
111111111111BBBBBB1
