START:12,8
TOTAL_TILES:16
COIN_BAGS:
KEYS:
BLOCKS:
TELEPORTS:
1111111111111111111
1111111111111111111
1111111111111111111
1111111111111111111
1111111111111111111
1111111111111111111
1111111111111111111
1111111111111111111
1111111111BBABB1111
1111111111BB1BB1111
1111111111BBBB11111
1111111111BBB111111
1111111111119111111
1111111111111111111
1111111111111111111
