START:2,7
TOTAL_TILES:16
COIN_BAGS:
KEYS:
BLOCKS:
TELEPORTS:
1111111111111111111
1111111111111111111
1111111111111111111
1111111111111111111
1111111111111111111
1111111111111111111
1111111111111111111
11A1111111111111111
BBB1111111111111111
BBB1111111111111111
BBBBB11111111111111
BBBB911111111111111
1111111111111111111
1111111111111111111
1111111111111111111
