START:5,6
TOTAL_TILES:16
COIN_BAGS:
KEYS:
BLOCKS:
TELEPORTS:
1111111111111111111
1111111111111111111
1111111119B11111111
1111111111B11111111
111111111BB11111111
111111111B111111111
11111ABBBB111111111
1111111BB1111111111
1111111BB1111111111
1111111BB1111111111
1111111111111111111
1111111111111111111
1111111111111111111
1111111111111111111
1111111111111111111
