START:13,14
TOTAL_TILES:16
COIN_BAGS:
KEYS:
BLOCKS:
TELEPORTS:
1111111111111111111
1111111111111111111
1111111111111111111
1111111111111111111
1111111111111111111
1111111111111111111
1111111111111111111
1111111111911111111
1111111111B11111111
1111111111B11111111
1111111111BB1111111
11111111111BBBBB111
1111111111111BBB111
111111111111BB11111
111111111111BA11111
