START:17,10
TOTAL_TILES:16
COIN_BAGS:
KEYS:
BLOCKS:
TELEPORTS:
1111111111111111111
1111111111111111111
1111111111111111111
1111111111111111111
1111111111111111111
1111111111111111111
1111111111111111111
1111111111111111111
1111111111111111111
1111111111111111111
11111111111111BBBA1
11111111111111B1111
11111111111111BB111
1111111111911BBB111
1111111111BBBBBB111
