START:18,9
TOTAL_TILES:16
COIN_BAGS:
KEYS:
BLOCKS:
TELEPORTS:
1111111111111111111
1111111111111111111
1111111111111111111
1111111111111111111
1111111111111111111
11111111111111BBBB9
1111111111111BBBB11
1111111111111BBBBBB
111111111111111111B
111111111111111111A
1111111111111111111
1111111111111111111
1111111111111111111
1111111111111111111
1111111111111111111
