START:4,7
TOTAL_TILES:16
COIN_BAGS:
KEYS:
BLOCKS:
TELEPORTS:
1111111111111111111
1111111111111111111
1111111111111111111
1111111111111111111
1111111111111111111
1111111111111111111
1111111111111111111
1111AB1111111111111
BB111B1111111111111
BB91BB1111111111111
BBBBB11111111111111
BB11111111111111111
1111111111111111111
1111111111111111111
1111111111111111111
