START:3,11
TOTAL_TILES:16
COIN_BAGS:
KEYS:
BLOCKS:
TELEPORTS:
1111111111111111111
1111111111111111111
1111111111111111111
1111111111111111111
1111111111111111111
1111111111111111111
1111111111111111111
1111111111111111111
1111111111111111111
111119B111111111111
11111BB111111111111
111A1B1111111111111
111BBB1111111111111
1BBBB11111111111111
1BBBB11111111111111
