START:14,1
TOTAL_TILES:16
COIN_BAGS:
KEYS:
BLOCKS:
TELEPORTS:
1111111111111BB1111
1111111111111BA1111
1111111111111B11111
111111111111BB11111
111111111111BB11111
1111111111111BBBB11
1111111111111119B11
111111111111111BB11
1111111111111111111
1111111111111111111
1111111111111111111
1111111111111111111
1111111111111111111
1111111111111111111
1111111111111111111
