START:13,11
TOTAL_TILES:16
COIN_BAGS:
KEYS:
BLOCKS:
TELEPORTS:
1111111111111111111
1111111111111111111
1111111111111111111
1111111111111111111
1111111111111111111
1111111111111111111
1111111111111111119
111111111111111111B
111111111111111111B
111111111111111111B
111111111111111111B
1111111111111ABBB1B
1111111111111111BBB
11111111111111111BB
11111111111111111BB
