START:11,1
TOTAL_TILES:16
COIN_BAGS:
KEYS:
BLOCKS:
TELEPORTS:
1111111111111111111
11111111111A1111111
11111111BB9B1111111
11111111B11B1111111
11111111B1BB1111111
11111111B1BB1111111
11111111BBBB1111111
1111111111111111111
1111111111111111111
1111111111111111111
1111111111111111111
1111111111111111111
1111111111111111111
1111111111111111111
1111111111111111111
