START:9,7
TOTAL_TILES:16
COIN_BAGS:
KEYS:
BLOCKS:
TELEPORTS:
1111111111111111111
1111111111111111111
11111111119BBB11111
11111111111BBB11111
11111111111BBB11111
11111111111BBB11111
1111111111BB1111111
111111111AB11111111
1111111111111111111
1111111111111111111
1111111111111111111
1111111111111111111
1111111111111111111
1111111111111111111
1111111111111111111
