START:0,13
TOTAL_TILES:14
COIN_BAGS:
KEYS:
BLOCKS:
TELEPORTS:
1111111111111111111
1111111111111111111
1111111111111111111
1111111111111111111
1111111111111111111
1111111111111111111
1111111111111111111
1111111111111111111
1111111111111111111
1111111111111111111
1BBB111111111111111
BBBB111111111111111
B9B1111111111111111
ABB1111111111111111
BB11111111111111111
