START:4,12
TOTAL_TILES:16
COIN_BAGS:
KEYS:
BLOCKS:
TELEPORTS:
1111111111111111111
1111111111111111111
9111111111111111111
B111111111111111111
BB11111111111111111
1BB1111111111111111
11BB111111111111111
111B111111111111111
11BB111111111111111
11BB111111111111111
111B111111111111111
111B111111111111111
111BA11111111111111
1111111111111111111
1111111111111111111
