START:0,9
TOTAL_TILES:16
COIN_BAGS:
KEYS:
BLOCKS:
TELEPORTS:
1111111111111111111
1111111111111111111
1111111111111111111
1111111111111111111
1111111111111111111
1111111111111111111
1111111111111111111
1111111111111111111
1111111111111111111
A1BBBB1111111111111
BBBBBB1111111111111
9BBBBB1111111111111
1111111111111111111
1111111111111111111
1111111111111111111
