START:5,10
TOTAL_TILES:16
COIN_BAGS:
KEYS:
BLOCKS:
TELEPORTS:
1111111111111111111
1111111111111111111
1111111111111111111
1111111111111111111
1111111111111111111
1111111111111111111
11111111111BB911111
11111111111BBB11111
1111111111BBBB11111
1111111111B11111111
11111ABBBBB11111111
1111111111111111111
1111111111111111111
1111111111111111111
1111111111111111111
