START:2,4
TOTAL_TILES:16
COIN_BAGS:
KEYS:
BLOCKS:
TELEPORTS:
11BBB11111111111111
11BBB11111111111111
11BBB11111111111111
11B1B11111111111111
11A1BB1111111111111
1111BB1111111111111
1111911111111111111
1111111111111111111
1111111111111111111
1111111111111111111
1111111111111111111
1111111111111111111
1111111111111111111
1111111111111111111
1111111111111111111
