START:8,12
TOTAL_TILES:16
COIN_BAGS:
KEYS:
BLOCKS:
TELEPORTS:
1111111111111111111
1111111111111111111
1111111111111111111
1111111111111111111
111111111BB11111111
111111111BB11111111
111111111BB11111111
111111111BB91111111
11111111BB111111111
11111111B1111111111
1111111BB1111111111
1111111BB1111111111
11111111A1111111111
1111111111111111111
1111111111111111111
