START:7,0
TOTAL_TILES:16
COIN_BAGS:
KEYS:
BLOCKS:
TELEPORTS:
11BBBBBA11111111111
11BBBB1111111111111
111B111111111111111
111B111111111111111
111B111111111111111
11BB111111111111111
11B9111111111111111
1111111111111111111
1111111111111111111
1111111111111111111
1111111111111111111
1111111111111111111
1111111111111111111
1111111111111111111
1111111111111111111
