START:0,11
TOTAL_TILES:16
COIN_BAGS:
KEYS:
BLOCKS:
TELEPORTS:
1111111111111111111
1111111111111111111
1111111111111111111
1111111111111111111
11111BBB11111111111
11111B1B11111111111
11BBBB1911111111111
11B1111111111111111
11B1111111111111111
11B1111111111111111
11B1111111111111111
ABB1111111111111111
1111111111111111111
1111111111111111111
1111111111111111111
