START:10,14
TOTAL_TILES:16
COIN_BAGS:
KEYS:
BLOCKS:
TELEPORTS:
1111111111111111111
1111111111111111111
1111111111111111111
1111111111111111111
1111111111111111111
1111111111111111111
1111111111111111111
1111111111111111111
11111111BBBBB111111
11111111BB11B111111
111111111B11B111111
111111111BB9B111111
1111111111B11111111
1111111111B11111111
1111111111A11111111
