START:16,7
TOTAL_TILES:16
COIN_BAGS:
KEYS:
BLOCKS:
TELEPORTS:
11111111111111BBBB1
111111111111119BBB1
111111111111111B111
11111111111111BB111
11111111111111B1111
11111111111111BBB11
1111111111111111B11
1111111111111111A11
1111111111111111111
1111111111111111111
1111111111111111111
1111111111111111111
1111111111111111111
1111111111111111111
1111111111111111111
