START:9,8
TOTAL_TILES:16
COIN_BAGS:
KEYS:
BLOCKS:
TELEPORTS:
1111111111111111111
1111111111111111111
1111111111111111111
1111111111111111111
1111111111111111111
1111111111111111111
1111111111BBBBBB111
111111111BB11B9B111
111111111A111BBB111
11111111111111BB111
1111111111111111111
1111111111111111111
1111111111111111111
1111111111111111111
1111111111111111111
