START:5,2
TOTAL_TILES:16
COIN_BAGS:
KEYS:
BLOCKS:
TELEPORTS:
1111111111111111111
1111111111111111111
11111A1111111111111
11111B111BB11111111
11111BBBBBBBB111111
111111111111B111111
111111111111B111111
111111111111BB91111
1111111111111111111
1111111111111111111
1111111111111111111
1111111111111111111
1111111111111111111
1111111111111111111
1111111111111111111
