START:3,1
TOTAL_TILES:16
COIN_BAGS:
KEYS:
BLOCKS:
TELEPORTS:
BBB1111111111111111
BBBA111111111111111
1B11111111111111111
BB11111111111111111
BB11111111111111111
1B11111111111111111
1B11111111111111111
BB11111111111111111
9111111111111111111
1111111111111111111
1111111111111111111
1111111111111111111
1111111111111111111
1111111111111111111
1111111111111111111
