START:17,12
TOTAL_TILES:16
COIN_BAGS:
KEYS:
BLOCKS:
TELEPORTS:
1111111111111111111
1111111111111111111
1111111111111111111
1111111111111111111
1111111111111111111
1111111111111111111
1111111111111111111
1111111111111111111
1111111111111111111
11111111111111111BB
1111111111111111BBB
1111111111111111B1B
1111111111111111BAB
111111111111111BBBB
11111111111119BB111
