START:10,11
TOTAL_TILES:16
COIN_BAGS:
KEYS:
BLOCKS:
TELEPORTS:
1111111111111111111
1111111111111111111
1111111111111111111
1111111111111111111
1111111111111111111
1111111111111111111
1111111111111111111
1111111111111111111
111111111BBB1111111
111111111BBB1111111
1111111111BB1111111
1111111111AB1191111
11111111111BB1B1111
111111111111BBB1111
1111111111111111111
