START:0,8
TOTAL_TILES:16
COIN_BAGS:
KEYS:
BLOCKS:
TELEPORTS:
9111111111111111111
BB11111111111111111
BB11111111111111111
B111111111111111111
B111111111111111111
B111111111111111111
BB11111111111111111
1B11111111111111111
AB11111111111111111
BB11111111111111111
BB11111111111111111
1111111111111111111
1111111111111111111
1111111111111111111
1111111111111111111
