START:10,3
TOTAL_TILES:16
COIN_BAGS:
KEYS:
BLOCKS:
TELEPORTS:
1111111111111111111
1111111111111111111
1111111111111111111
1111111111ABB111111
111111111111B111111
111111111111B111111
111111111111BBB1111
1111111111111BB1111
1111111111111B11111
1111111111111B11111
1111111111111B11111
1111111111111B91111
1111111111111BB1111
1111111111111111111
1111111111111111111
