START:9,3
TOTAL_TILES:16
COIN_BAGS:
KEYS:
BLOCKS:
TELEPORTS:
1111111111111111111
1111111111111111111
1111111111111111111
111111111A111111111
11111BBBBB111111111
11111BB111111111111
1111BBB111111111111
111BB11111111111111
111B111111111111111
111B111111111111111
119B111111111111111
1111111111111111111
1111111111111111111
1111111111111111111
1111111111111111111
