START:18,13
TOTAL_TILES:16
COIN_BAGS:
KEYS:
BLOCKS:
TELEPORTS:
1111111111111111111
1111111111111111111
1111111111111111111
1111111111111111111
1111111111111111111
111111111111BB11111
111111111111B911111
111111111111BBB1111
11111111111111BBBBB
111111111111111111B
111111111111111111B
111111111111111111B
111111111111111111B
111111111111111111A
1111111111111111111
