START:12,9
TOTAL_TILES:16
COIN_BAGS:
KEYS:
BLOCKS:
TELEPORTS:
1111111111111111111
1111111111111111111
1111111111111111111
1111111111BB1111111
1111111111BB1911111
111111111BBBBB11111
111111111BB11111111
1111111111BB1111111
11111111111BB111111
111111111111A111111
1111111111111111111
1111111111111111111
1111111111111111111
1111111111111111111
1111111111111111111
