START:0,6
TOTAL_TILES:16
COIN_BAGS:
KEYS:
BLOCKS:
TELEPORTS:
111BB11111111111111
BBBBBB1111111111111
B111BB1111111111111
B111B11111111111111
B111911111111111111
B111111111111111111
A111111111111111111
1111111111111111111
1111111111111111111
1111111111111111111
1111111111111111111
1111111111111111111
1111111111111111111
1111111111111111111
1111111111111111111
