START:4,14
TOTAL_TILES:16
COIN_BAGS:
KEYS:
BLOCKS:
TELEPORTS:
1111111111111111111
1111111111111111111
1111111111111111111
1111111111111111111
1111111111111111111
1111111111111111111
1111911111111111111
1111BBB111111111111
111111BB11111111111
1111111BB1111111111
11111111B1111111111
1111111BB1111111111
1111111B11111111111
1111111B11111111111
1111ABBB11111111111
