START:4,6
TOTAL_TILES:16
COIN_BAGS:
KEYS:
BLOCKS:
TELEPORTS:
1BBBBB1111111111111
1BB9BB1111111111111
1111B11111111111111
1111B11111111111111
1111B11111111111111
1111BB1111111111111
1111AB1111111111111
1111111111111111111
1111111111111111111
1111111111111111111
1111111111111111111
1111111111111111111
1111111111111111111
1111111111111111111
1111111111111111111
