START:8,2
TOTAL_TILES:16
COIN_BAGS:
KEYS:
BLOCKS:
TELEPORTS:
111111111BB11111111
111111111BB11111111
11111111ABBB1111111
11111111111BB111111
111111111111B191111
111111111111BBB1111
1111111111111BB1111
1111111111111111111
1111111111111111111
1111111111111111111
1111111111111111111
1111111111111111111
1111111111111111111
1111111111111111111
1111111111111111111
