START:3,6
TOTAL_TILES:16
COIN_BAGS:
KEYS:
BLOCKS:
TELEPORTS:
1111111111111111111
1111111111111111111
1111111111111111111
1111111111111111111
1111111111111111111
1111111111111111111
111AB11111111111111
1111B11111111111111
1111B11111111111111
1111BB1111111111111
11111BB911111111111
1111BBB111111111111
1111BBB111111111111
1111BB1111111111111
1111111111111111111
