START:5,4
TOTAL_TILES:16
COIN_BAGS:
KEYS:
BLOCKS:
TELEPORTS:
111111111BB91111111
111111111B111111111
111111111B111111111
111111111BB11111111
11111A1111B11111111
11111BBBBBB11111111
11111111BB111111111
1111111111111111111
1111111111111111111
1111111111111111111
1111111111111111111
1111111111111111111
1111111111111111111
1111111111111111111
1111111111111111111
