START:1,9
TOTAL_TILES:16
COIN_BAGS:
KEYS:
BLOCKS:
TELEPORTS:
1111111111111111111
1111111111111111111
1111111111111111111
1111111111111111111
1111111111111111111
1111111111111111111
1111111111111111111
1111111111111111111
1111111111111111111
BA11191111111111111
BB1BBB1111111111111
BBBBBB1111111111111
BBB1111111111111111
1111111111111111111
1111111111111111111
