START:7,10
TOTAL_TILES:16
COIN_BAGS:
KEYS:
BLOCKS:
TELEPORTS:
1111111111111111111
1111111111111111111
1111111111111111111
1111111111111111111
1111111111111111111
1111111111111111111
1111111111111111111
1111111111111111111
1111111111111111111
11111111BB111111111
1111111ABB111111111
11111111BB111111111
11111111BB111111111
111111111B9BB111111
111111111BBBB111111
