START:0,7
TOTAL_TILES:16
COIN_BAGS:
KEYS:
BLOCKS:
TELEPORTS:
1111111111111111111
1111111111111111111
1111111111111111111
1111111111111111111
B911111111111111111
BBB1111111111111111
11B1111111111111111
A1B1111111111111111
BBB1111111111111111
BB11111111111111111
BB11111111111111111
BB11111111111111111
1111111111111111111
1111111111111111111
1111111111111111111
