START:17,3
TOTAL_TILES:16
COIN_BAGS:
KEYS:
BLOCKS:
TELEPORTS:
1111111111111111111
1111111111111111111
1111111111111111111
11111111111111111AB
111111111111111111B
111111111111111111B
111111111111111111B
111111111111111111B
11111111111111BBB1B
11111111111119B1BBB
11111111111111111BB
1111111111111111111
1111111111111111111
1111111111111111111
1111111111111111111
