START:10,10
TOTAL_TILES:16
COIN_BAGS:
KEYS:
BLOCKS:
TELEPORTS:
1111111111111111111
1111111111111111111
1111111111111111111
1111111111111111111
1111111111111111111
1111111111111111111
1111111111BBB111111
111111111BBBB111111
11119BBBBBBB1111111
1111111111B11111111
1111111111A11111111
1111111111111111111
1111111111111111111
1111111111111111111
1111111111111111111
