START:8,8
TOTAL_TILES:16
COIN_BAGS:
KEYS:
BLOCKS:
TELEPORTS:
1111111111111111111
1111111111111111111
1111111111111111111
1111111111111111111
1111111111111111111
1111111111111111111
1111911111111111111
1111BB11BB111111111
11111BBBABB11111111
1111111BBBB11111111
11111111BB111111111
1111111111111111111
1111111111111111111
1111111111111111111
1111111111111111111
