START:12,0
TOTAL_TILES:16
COIN_BAGS:
KEYS:
BLOCKS:
TELEPORTS:
11111111111BA111111
11111111111B1111111
11111111111B1111111
11111111111BB111111
11111111111BB111111
1111111111BBBB11111
1111111111BBBB11111
1111111111111911111
1111111111111111111
1111111111111111111
1111111111111111111
1111111111111111111
1111111111111111111
1111111111111111111
1111111111111111111
