START:7,5
TOTAL_TILES:16
COIN_BAGS:
KEYS:
BLOCKS:
TELEPORTS:
1111111111111111111
1111111111111111111
1111111111111111111
1111111111111111111
1111111111111111111
111111BA11111111111
111111BB11111111111
1111111B11111111111
1111111BBB111111111
111111111BBBBB11111
11111111111BBB11111
1111111111191111111
1111111111111111111
1111111111111111111
1111111111111111111
