START:10,9
TOTAL_TILES:16
COIN_BAGS:
KEYS:
BLOCKS:
TELEPORTS:
1111111111111111111
1111111111111111111
1111111111111111111
1111111111111111111
1111111111111111111
1111111111111111111
1111111111111111111
1111111111111111111
111111111111191BB11
1111111111AB1BBBB11
11111111111B1111B11
11111111111BBBBBB11
1111111111111111111
1111111111111111111
1111111111111111111
