START:9,12
TOTAL_TILES:16
COIN_BAGS:
KEYS:
BLOCKS:
TELEPORTS:
1111111111111111111
1111111111111111111
1111111111111111111
1111111111111111111
1111111111111111111
1111111111111111111
111119B111111111111
111111B111111111111
1111BBB111111111111
1111BBBB11111111111
111111BB11111111111
111111BBBB111111111
111111111A111111111
1111111111111111111
1111111111111111111
