START:3,12
TOTAL_TILES:16
COIN_BAGS:
KEYS:
BLOCKS:
TELEPORTS:
1111111111111111111
1111111111111111111
1111111111111111111
1111111111111111111
1111111111111111111
1111111111111111111
1111111111111111111
BB91111111111111111
B111111111111111111
B111111111111111111
BB11111111111111111
BB11111111111111111
B1BA111111111111111
BBB1111111111111111
BB11111111111111111
