START:18,5
TOTAL_TILES:14
COIN_BAGS:
KEYS:
BLOCKS:
TELEPORTS:
1111111111111111111
111111111111119BBBB
1111111111111111BBB
111111111111111111B
11111111111111111BB
11111111111111111BA
11111111111111111BB
1111111111111111111
1111111111111111111
1111111111111111111
1111111111111111111
1111111111111111111
1111111111111111111
1111111111111111111
1111111111111111111
