START:10,12
TOTAL_TILES:16
COIN_BAGS:
KEYS:
BLOCKS:
TELEPORTS:
1111111111111111111
1111111111111111111
1111111111111111111
1111111111111111111
1111111111111111111
1111111111111111111
1111111111111111111
1111111111111111111
1111111111111111111
11111111BBB11111111
11111111BBB11111111
11111111BBB11111111
11111111BBA11111111
111111111B111111111
111111111BBB9111111
