START:6,2
TOTAL_TILES:16
COIN_BAGS:
KEYS:
BLOCKS:
TELEPORTS:
1111111111111111111
1111111111111111111
111111ABB1111111111
11111111B1111111111
11111111B1111111111
111111BBB1111111111
111111B11B911111111
111111B1BB111111111
111111BBB1111111111
1111111111111111111
1111111111111111111
1111111111111111111
1111111111111111111
1111111111111111111
1111111111111111111
