START:2,4
TOTAL_TILES:16
COIN_BAGS:
KEYS:
BLOCKS:
TELEPORTS:
1111111111111111111
1111111111111111111
1111111111111111111
1111111111111111111
11A1111111111111111
11B1BB1111111111111
11BBBB1111111111111
11BBB91111111111111
11BBB11111111111111
11BB111111111111111
1111111111111111111
1111111111111111111
1111111111111111111
1111111111111111111
1111111111111111111
