START:13,6
TOTAL_TILES:16
COIN_BAGS:
KEYS:
BLOCKS:
TELEPORTS:
1111111111111111111
1111111111111111111
1111111111111111111
1111111111111111111
1111111111111111111
1111111111111111111
1111111111111A11111
1111111111111B11111
1111111111111B11111
1111111111111B11111
11111111111BBBBB111
11111111119BBBBB111
11111111111111BB111
1111111111111111111
1111111111111111111
