START:1,13
TOTAL_TILES:16
COIN_BAGS:
KEYS:
BLOCKS:
TELEPORTS:
1111111111111111111
1111111111111111111
1111111111111111111
1111111111111111111
1111111111111111111
1111111111111111111
1111111111111111111
1111111111111111111
1111111111111111111
1111BB1111111111111
119BBB1111111111111
11BBBB1111111111111
111BB11111111111111
1A1B111111111111111
1BBB111111111111111
