START:4,8
TOTAL_TILES:16
COIN_BAGS:
KEYS:
BLOCKS:
TELEPORTS:
1111111111111111111
1111111111111111111
1111111111111111111
1111111111111111111
1111111111111111111
1111111111111111111
1111111111111111111
11111BB1BB111111111
1111ABBBBBBB9111111
111111BB11111111111
111111BB11111111111
1111111111111111111
1111111111111111111
1111111111111111111
1111111111111111111
