START:7,9
TOTAL_TILES:16
COIN_BAGS:
KEYS:
BLOCKS:
TELEPORTS:
1111111111111111111
1111111111111111111
1111111111111111111
1111111111111111111
1111111111111111111
1111111111111111111
1111111111111111111
111111BBB1111111111
111BB1B1B1111111111
1119BBBAB1111111111
1111BB1111111111111
1111BB1111111111111
1111111111111111111
1111111111111111111
1111111111111111111
