START:17,4
TOTAL_TILES:16
COIN_BAGS:
KEYS:
BLOCKS:
TELEPORTS:
1111111111111111111
1111111111111111111
1111111111111111111
1111111111111111111
11111111111111111A1
11111111111111111B1
1111111111111119BB1
11111111111111BBB11
1111111111111BBBB11
1111111111111BBB111
1111111111111BB1111
1111111111111111111
1111111111111111111
1111111111111111111
1111111111111111111
