START:11,5
TOTAL_TILES:16
COIN_BAGS:
KEYS:
BLOCKS:
TELEPORTS:
1111111111111111111
1111111111111111111
1111111111111111111
1111111111111111111
1111111111111111111
11111111111A1111111
11111111111BB111111
111111111111B111111
111111111111BBB1111
1111111111111BB1111
1111111111111BB1111
1111111111111BB1111
1111111111111B91111
1111111111111BB1111
1111111111111111111
