START:6,5
TOTAL_TILES:16
COIN_BAGS:
KEYS:
BLOCKS:
TELEPORTS:
1111111111111111111
1111111111111111111
1111111111111111111
1111911111111111111
1111B11111111111111
11BBBBA111111111111
1BB1BB1111111111111
1BBBB11111111111111
1BB1111111111111111
1111111111111111111
1111111111111111111
1111111111111111111
1111111111111111111
1111111111111111111
1111111111111111111
