START:10,9
TOTAL_TILES:16
COIN_BAGS:
KEYS:
BLOCKS:
TELEPORTS:
1111111111111111111
1111111111111111111
1111111111111111111
1111111111111111111
1111111111111111111
1111111111111111111
1111111111111111111
1111111111111111111
1111111111111111111
1111111111A111BB111
1111111111BBBBBBB11
1111111111111111B11
1111111111111111B11
1111111111111111BB1
1111111111111119BB1
