START:3,1
TOTAL_TILES:16
COIN_BAGS:
KEYS:
BLOCKS:
TELEPORTS:
1111BB1111111111111
111ABB1111111111111
11111B1111111111111
11111BB111111111111
111111BBBB111111111
111111111B111111111
111111119B111111111
11111111BB111111111
1111111111111111111
1111111111111111111
1111111111111111111
1111111111111111111
1111111111111111111
1111111111111111111
1111111111111111111
