START:13,0
TOTAL_TILES:16
COIN_BAGS:
KEYS:
BLOCKS:
TELEPORTS:
1111111111111AB1111
11111111111111BB111
1111111111111BBB111
1111111111111B11111
1111111111111B11111
1111111111111BBB111
111111111111111B111
111111111111111B111
111111111111111B111
111111111111119B111
1111111111111111111
1111111111111111111
1111111111111111111
1111111111111111111
1111111111111111111
