START:6,5
TOTAL_TILES:16
COIN_BAGS:
KEYS:
BLOCKS:
TELEPORTS:
111119BB11111111111
11111BBBB1111111111
11111BBBB1111111111
11111BBB11111111111
11111BB111111111111
111111A111111111111
1111111111111111111
1111111111111111111
1111111111111111111
1111111111111111111
1111111111111111111
1111111111111111111
1111111111111111111
1111111111111111111
1111111111111111111
