START:8,9
TOTAL_TILES:16
COIN_BAGS:
KEYS:
BLOCKS:
TELEPORTS:
1111111111111111111
1111111111111111111
1111111111111111111
1111111111111111111
1111111111111111111
1111111111111111111
1111111111111111111
1111111111111111111
1111111111111111111
11111111A1111111111
11111111BBB11111111
1111111111BB1111111
111111111BBB1111111
111111111B111191111
111111111BBBBBB1111
