START:12,10
TOTAL_TILES:16
COIN_BAGS:
KEYS:
BLOCKS:
TELEPORTS:
1111111111111111111
1111111111111111111
1111111111111111111
1111111111111111111
1111111111111111111
1111111111111111111
1111111111111111111
111111111111BBB1111
11111111111BB1BB111
11111111111BB91B111
111111111111AB1B111
1111111111111BBB111
1111111111111111111
1111111111111111111
1111111111111111111
