START:13,14
TOTAL_TILES:16
COIN_BAGS:
KEYS:
BLOCKS:
TELEPORTS:
1111111111111111111
1111111111111111111
1111111111111111111
1111111111111111111
1111111111111111111
1111111111111111111
1111111111111111111
1111111111111111111
1111111111111111111
1111111111111111111
1111111111111111111
1111111111111111111
1111111BBB111111111
11111B9B1BBBB111111
11111BBB11BBBA11111
