START:7,9
TOTAL_TILES:16
COIN_BAGS:
KEYS:
BLOCKS:
TELEPORTS:
1111111111111111111
1111111111111111111
1111111111111111111
1111111111111111111
1111111111111111111
111119BBBB111111111
111111111B111111111
11111111BB111111111
11111111BB111111111
111111BABB111111111
111111BBB1111111111
1111111111111111111
1111111111111111111
1111111111111111111
1111111111111111111
