START:14,7
TOTAL_TILES:16
COIN_BAGS:
KEYS:
BLOCKS:
TELEPORTS:
1111111119B11111111
1111111111B11111111
111111111BB11111111
111111111BBB1111111
11111111111BBB11111
111111111111BB11111
111111111111BBB1111
11111111111111A1111
1111111111111111111
1111111111111111111
1111111111111111111
1111111111111111111
1111111111111111111
1111111111111111111
1111111111111111111
