START:9,8
TOTAL_TILES:16
COIN_BAGS:
KEYS:
BLOCKS:
TELEPORTS:
1111111111111111111
1111111111111111111
1111111111111111111
11111BB111111111111
11111BBB11111111111
1111BBBB11111111111
1111B9B111111111111
111111B111111111111
111111BBBA111111111
1111111111111111111
1111111111111111111
1111111111111111111
1111111111111111111
1111111111111111111
1111111111111111111
