START:15,4
TOTAL_TILES:16
COIN_BAGS:
KEYS:
BLOCKS:
TELEPORTS:
11111111111BBBB1111
11111111111BB1BB111
111111111111B11B111
111111111111B11B111
111111111111B11A111
11111111111BB111111
1111111111191111111
1111111111111111111
1111111111111111111
1111111111111111111
1111111111111111111
1111111111111111111
1111111111111111111
1111111111111111111
1111111111111111111
