START:10,4
TOTAL_TILES:16
COIN_BAGS:
KEYS:
BLOCKS:
TELEPORTS:
1111111111111111111
1111111111111111111
1111111111111111111
1111111111111111111
11111111BBA11111111
1111111BB1111111111
1111111B11111111111
11111BBB11111111111
11111B1111111111111
11111B1111111111111
111BBB1111111111111
1119BB1111111111111
1111111111111111111
1111111111111111111
1111111111111111111
