START:15,9
TOTAL_TILES:16
COIN_BAGS:
KEYS:
BLOCKS:
TELEPORTS:
1111111111111111111
1111111111111111111
1111111111111111111
1111111111111111111
1111111111111111111
1111111111111111111
1111111111111111111
1111111111111111111
1111111111111111111
11111111111111BA111
11111111111111B1111
11111111111111BB111
111111111111BBBB111
111111111111BBBB111
111111111111BB9B111
