START:13,5
TOTAL_TILES:16
COIN_BAGS:
KEYS:
BLOCKS:
TELEPORTS:
1111111111111111111
1111111111111111111
1111111111111111111
1111111111111111111
1111111111111111111
1111111111111A11111
111111111111BB11111
11111111111BB111111
11111111111B1111111
11111111111B1111111
111111111BBBB111111
11111119BBBBB111111
1111111111111111111
1111111111111111111
1111111111111111111
