START:14,11
TOTAL_TILES:16
COIN_BAGS:
KEYS:
BLOCKS:
TELEPORTS:
1111111111111111111
1111111111111111111
1111111111111111191
11111111111111111B1
11111111111111111B1
1111111111111111BB1
11111111111111BBB11
11111111111111BB111
111111111111111B111
1111111111111BBB111
1111111111111B11111
1111111111111BA1111
1111111111111111111
1111111111111111111
1111111111111111111
