START:9,2
TOTAL_TILES:16
COIN_BAGS:
KEYS:
BLOCKS:
TELEPORTS:
1111111111111111111
1111111111111111111
11111111BA111111111
11111111B1111111111
11111111BBBB1111111
11111111BBBB1111111
11111111BBBB1111111
11111111119B1111111
1111111111111111111
1111111111111111111
1111111111111111111
1111111111111111111
1111111111111111111
1111111111111111111
1111111111111111111
