START:5,11
TOTAL_TILES:16
COIN_BAGS:
KEYS:
BLOCKS:
TELEPORTS:
1111111111111111111
1111111111111111111
1111111111111111111
1111111111111111111
1111111111111111111
1111111111111111111
1111111BB1111111111
11111119B1111111111
11111111B1111111111
111BBBB1B1111111111
111BBBBBB1111111111
11111A1111111111111
1111111111111111111
1111111111111111111
1111111111111111111
