START:8,10
TOTAL_TILES:16
COIN_BAGS:
KEYS:
BLOCKS:
TELEPORTS:
1111111111111111111
1111111111111111111
1111111111111111111
1111111111111111111
1111111111111111111
1111111111111111111
1111111111111111111
1111111911111111111
111111BB11111111111
111111B111111111111
1111BBBBA1111111111
1111BB1B11111111111
11111BBB11111111111
11111BB111111111111
1111111111111111111
