START:7,2
TOTAL_TILES:16
COIN_BAGS:
KEYS:
BLOCKS:
TELEPORTS:
1111111111111111111
1111111BBBB11111111
1111111A1BB11111111
111111111BB11111111
1111111111BB1111111
11111111111BB111111
111111111111B911111
111111111111BB11111
1111111111111111111
1111111111111111111
1111111111111111111
1111111111111111111
1111111111111111111
1111111111111111111
1111111111111111111
