START:14,6
TOTAL_TILES:14
COIN_BAGS:
KEYS:
BLOCKS:
TELEPORTS:
1111111111111111111
1111111111111111111
1111111111111111111
1111111111111111111
11111111111111BB111
1111111111111BBB111
111111111111BBAB911
111111111111BBBBB11
1111111111111111111
1111111111111111111
1111111111111111111
1111111111111111111
1111111111111111111
1111111111111111111
1111111111111111111
