START:8,0
TOTAL_TILES:16
COIN_BAGS:
KEYS:
BLOCKS:
TELEPORTS:
11111111A1111111111
1111111BB1111111111
1111111B11111111111
1111111BB1111911111
11111111BB1BBB11111
111111111BBB1111111
111111111BB11111111
1111111111111111111
1111111111111111111
1111111111111111111
1111111111111111111
1111111111111111111
1111111111111111111
1111111111111111111
1111111111111111111
