START:9,8
TOTAL_TILES:16
COIN_BAGS:
KEYS:
BLOCKS:
TELEPORTS:
1111111111111111111
1111111111111111111
1111111111111111111
1111111111111111111
1111111111111111111
1111111111111111111
1111111111111111111
111111111BBBB111111
111111111ABBB111111
1111111111BBBB11111
111111111111BB11111
111111111111BB11111
1111111111111911111
1111111111111111111
1111111111111111111
