START:3,2
TOTAL_TILES:16
COIN_BAGS:
KEYS:
BLOCKS:
TELEPORTS:
1111BB1111111111111
1111BBBB11111111111
111AB11BB1111111111
11111111B1111111111
11111111B1111111111
11111111BB111111111
111111111B111111111
111111111B911111111
1111111111111111111
1111111111111111111
1111111111111111111
1111111111111111111
1111111111111111111
1111111111111111111
1111111111111111111
