START:14,2
TOTAL_TILES:16
COIN_BAGS:
KEYS:
BLOCKS:
TELEPORTS:
1111111111111111111
1111111111111111111
11111111111111A1111
11111111111111BB111
111111111111BBBB111
111111111111B1BB111
111111111111BB11111
1111111111111BBBB91
1111111111111111111
1111111111111111111
1111111111111111111
1111111111111111111
1111111111111111111
1111111111111111111
1111111111111111111
