START:17,2
TOTAL_TILES:16
COIN_BAGS:
KEYS:
BLOCKS:
TELEPORTS:
11111111111111111BB
11111111111111111BB
11111111111111111AB
111111111111111111B
1111111111111119BBB
111111111111111BBBB
111111111111111BB11
1111111111111111111
1111111111111111111
1111111111111111111
1111111111111111111
1111111111111111111
1111111111111111111
1111111111111111111
1111111111111111111
