START:2,6
TOTAL_TILES:16
COIN_BAGS:
KEYS:
BLOCKS:
TELEPORTS:
111111119B111111111
111111111B111111111
111111BBBB111111111
1111BBB111111111111
1111BB1111111111111
1111BB1111111111111
11ABB11111111111111
1111111111111111111
1111111111111111111
1111111111111111111
1111111111111111111
1111111111111111111
1111111111111111111
1111111111111111111
1111111111111111111
