START:11,5
TOTAL_TILES:16
COIN_BAGS:
KEYS:
BLOCKS:
TELEPORTS:
111111111B9BBB11111
111111111BBBBB11111
111111111BBBB111111
11111111111B1111111
11111111111B1111111
11111111111A1111111
1111111111111111111
1111111111111111111
1111111111111111111
1111111111111111111
1111111111111111111
1111111111111111111
1111111111111111111
1111111111111111111
1111111111111111111
