START:5,4
TOTAL_TILES:16
COIN_BAGS:
KEYS:
BLOCKS:
TELEPORTS:
1111111111111111111
1111111111111111111
1911111111111111111
BB11111111111111111
B111BA1111111111111
B111B11111111111111
B11BB11111111111111
B1BB111111111111111
BBB1111111111111111
1111111111111111111
1111111111111111111
1111111111111111111
1111111111111111111
1111111111111111111
1111111111111111111
