START:10,6
TOTAL_TILES:16
COIN_BAGS:
KEYS:
BLOCKS:
TELEPORTS:
1111111111111111111
1111111111111111111
1111111111111111111
1111111111111111111
1111111111111111111
1111111111111111111
1111111111A11111111
11111111BBB11111111
11111111BBBBBBB1111
111111111111BBB1111
111111111111B111111
111111111119B111111
1111111111111111111
1111111111111111111
1111111111111111111
