START:4,10
TOTAL_TILES:16
COIN_BAGS:
KEYS:
BLOCKS:
TELEPORTS:
1111111111111111111
1111111111111111111
1111111111111111111
111BBB1111111111111
111BBB1111111111111
1111BBB111111111111
1111BB9111111111111
11111B1111111111111
11111B1111111111111
1111BB1111111111111
1111A11111111111111
1111111111111111111
1111111111111111111
1111111111111111111
1111111111111111111
