START:8,6
TOTAL_TILES:16
COIN_BAGS:
KEYS:
BLOCKS:
TELEPORTS:
1111111111111111111
1111111111111111111
1111111111111111111
1111111111111111111
1111111111111111111
1111111111111111111
11111BBBA1111111111
11111BBB11111111111
11111BBBB1111111111
11111111B1111111111
11111111B1111111111
11111111B9111111111
11111111BB111111111
1111111111111111111
1111111111111111111
