START:4,14
TOTAL_TILES:16
COIN_BAGS:
KEYS:
BLOCKS:
TELEPORTS:
1111111111111111111
1111111111111111111
1111111111111111111
1111111111111111111
1111111111111111111
1111111111111111111
1111111111111111111
1111111111111111111
111BBBBB91111111111
11BB111111111111111
11BBB11111111111111
111BB11111111111111
111BB11111111111111
1111B11111111111111
1111A11111111111111
