START:18,11
TOTAL_TILES:16
COIN_BAGS:
KEYS:
BLOCKS:
TELEPORTS:
1111111111111111111
1111111111111111111
1111111111111111111
1111111111111111111
1111111111111111111
1111111111111111111
1111111111111111111
111111111111BB11111
111111111111BBBBB11
1111111111BBB111B11
1111111111B91111BB1
11111111111111111BA
1111111111111111111
1111111111111111111
1111111111111111111
