START:9,13
TOTAL_TILES:16
COIN_BAGS:
KEYS:
BLOCKS:
TELEPORTS:
1111111111111111111
1111111111111111111
1111111111111111111
1111111111111111111
1111111111111111111
1111111111111111111
1111111111111111111
1111111111111111111
1111111111111111111
111111BB11111111111
111111BBB1111111111
111119BBBBB11111111
1111111BBBB11111111
111111111AB11111111
1111111111111111111
