START:3,5
TOTAL_TILES:16
COIN_BAGS:
KEYS:
BLOCKS:
TELEPORTS:
1111111111111111111
1111111111111111111
1111111111111111111
1111111111111111111
1111111111111111111
111A111111111111111
111BBBBB11111111111
1111111B11111111111
1111111BB1BB1111111
11111111BBB91111111
111111111BB11111111
1111111111111111111
1111111111111111111
1111111111111111111
1111111111111111111
