START:10,8
TOTAL_TILES:16
COIN_BAGS:
KEYS:
BLOCKS:
TELEPORTS:
1111111111111111111
1111111111111111111
1111111111111111111
1111111111111111111
1111111111111111111
1111111111111111111
1111111111111111111
1111111111111111111
1111111111ABB111111
1111111111BBBBBBBB1
1111111111111111BB1
1111111111111111B11
1111111111111111BB1
1111111111111111191
1111111111111111111
