START:9,6
TOTAL_TILES:16
COIN_BAGS:
KEYS:
BLOCKS:
TELEPORTS:
1111111111111111111
1111111111111111111
1111111111111111111
1111111111111111111
1111111111111111111
1111111111111111111
111111111ABBB111111
11111111111BB111111
1111111111BB1111111
1111111191BB1111111
11111111BBBB1111111
1111111111BB1111111
1111111111111111111
1111111111111111111
1111111111111111111
