START:12,5
TOTAL_TILES:16
COIN_BAGS:
KEYS:
BLOCKS:
TELEPORTS:
111111111BBBB111111
111111111BBB9111111
111111111B111111111
111111111B111111111
111111111B111111111
111111111BB1A111111
1111111111BBB111111
1111111111111111111
1111111111111111111
1111111111111111111
1111111111111111111
1111111111111111111
1111111111111111111
1111111111111111111
1111111111111111111
