START:1,12
TOTAL_TILES:16
COIN_BAGS:
KEYS:
BLOCKS:
TELEPORTS:
1111111111111111111
1111111111111111111
1111111111111111111
1111111111111111111
1111111111111111111
1111111111111111111
1111111111111111111
1111111111111111111
1111BBB911111111111
1111B11111111111111
1111BB1111111111111
1111BB1111111111111
1ABBB11111111111111
1BB1111111111111111
1BB1111111111111111
