START:10,0
TOTAL_TILES:16
COIN_BAGS:
KEYS:
BLOCKS:
TELEPORTS:
111111111BA11111111
11111111BB111111111
11111111B1111111111
11111111B1111111111
1111111BB1111111111
1111BBBB11111111111
11BBB11111111111111
11B9111111111111111
1111111111111111111
1111111111111111111
1111111111111111111
1111111111111111111
1111111111111111111
1111111111111111111
1111111111111111111
