START:1,3
TOTAL_TILES:16
COIN_BAGS:
KEYS:
BLOCKS:
TELEPORTS:
1111111111111111111
1111111111111111111
1111111111111111111
1AB1111111111111111
11BBBBB111111111111
1111BBB111111111111
1111B11111111111111
1111B91111111111111
1111BB1111111111111
1111BB1111111111111
1111111111111111111
1111111111111111111
1111111111111111111
1111111111111111111
1111111111111111111
