START:5,5
TOTAL_TILES:16
COIN_BAGS:
KEYS:
BLOCKS:
TELEPORTS:
1111111111111111111
1111111111111111111
1111111111111111111
1111111111111111111
111BB11111111111111
111BBA1111111111111
111BB11111111111111
1111B11111111111111
11BBB11111111111111
1BB1111111111111111
BB11111111111111111
B911111111111111111
1111111111111111111
1111111111111111111
1111111111111111111
