START:11,3
TOTAL_TILES:16
COIN_BAGS:
KEYS:
BLOCKS:
TELEPORTS:
1111111111111111111
1111111111111111111
1111111111111111111
11111111111ABBB1111
1111111111111BB1111
1111111111111B19111
1111111111111BBB111
1111111111111BBB111
1111111111111BBB111
1111111111111111111
1111111111111111111
1111111111111111111
1111111111111111111
1111111111111111111
1111111111111111111
