START:16,0
TOTAL_TILES:16
COIN_BAGS:
KEYS:
BLOCKS:
TELEPORTS:
1111111111111111A11
1111111111111111B11
1111111111119111BB1
111111111111B11BBB1
111111111111BB1B111
1111111111111B1B111
1111111111111BBB111
1111111111111111111
1111111111111111111
1111111111111111111
1111111111111111111
1111111111111111111
1111111111111111111
1111111111111111111
1111111111111111111
