START:18,13
TOTAL_TILES:16
COIN_BAGS:
KEYS:
BLOCKS:
TELEPORTS:
1111111111111111111
1111111111111111111
1111111111111111111
1111111111111111111
1111111111111111111
1111111111111111111
11111111111111111BB
1111111111111111BBB
1111111111111119B1B
11111111111111111BB
1111111111111111BB1
1111111111111111B11
1111111111111111BBB
111111111111111111A
1111111111111111111
