START:3,1
TOTAL_TILES:16
COIN_BAGS:
KEYS:
BLOCKS:
TELEPORTS:
1111111111111111111
111AB11111111111111
1111B11111111111111
1111B11111111111111
111BB11111111111111
111BB11111111111111
11BBB11111111111111
11B1111111111111111
11B1111111111111111
1BB1111111111111111
1B91111111111111111
1111111111111111111
1111111111111111111
1111111111111111111
1111111111111111111
