START:12,11
TOTAL_TILES:16
COIN_BAGS:
KEYS:
BLOCKS:
TELEPORTS:
1111111111111111111
1111111111111111111
1111111111111111111
1111111111111111111
1111111111111111111
1111111111111111111
1111111111111111111
1111111111BBBB11111
111111111BB11B11111
111111111BBB1B11111
11111111111BBB11111
111111111111AB91111
1111111111111111111
1111111111111111111
1111111111111111111
