START:9,11
TOTAL_TILES:16
COIN_BAGS:
KEYS:
BLOCKS:
TELEPORTS:
1111111111111111111
1111111111111111111
1111111111111111111
1111111111111111111
1111111111111111111
1111111111111111111
1111111111111111111
1111111111111111111
1111111111111111111
111111111111BB11111
111111111111BBBB111
111111111ABBB1BB111
11111111111111B1111
11111111111111BB111
111111111111119B111
