START:17,6
TOTAL_TILES:16
COIN_BAGS:
KEYS:
BLOCKS:
TELEPORTS:
1111111111111111111
1111111111111111111
111111111119B111111
111111111111BB11111
1111111111111BB1111
1111111111111BB1111
111111111111BB1BBA1
111111111111BBBB111
1111111111111111111
1111111111111111111
1111111111111111111
1111111111111111111
1111111111111111111
1111111111111111111
1111111111111111111
