START:3,8
TOTAL_TILES:16
COIN_BAGS:
KEYS:
BLOCKS:
TELEPORTS:
1111111111111111111
1111111111111111111
1111111111111111111
1111111111111111111
1111111111111111111
1111111111111111111
111111BBBBB11111111
11111BB19BB11111111
111ABB1111111111111
1111BB1111111111111
1111BB1111111111111
1111111111111111111
1111111111111111111
1111111111111111111
1111111111111111111
