START:11,11
TOTAL_TILES:16
COIN_BAGS:
KEYS:
BLOCKS:
TELEPORTS:
1111111111111111111
1111111111111111111
1111111111111111111
1111111111111111111
1111111111111111111
11111111111BB111111
11111111111BB111111
111111111119B111111
111111111BBBB111111
111111111BB11111111
111111111BB11111111
111111111BBA1111111
1111111111111111111
1111111111111111111
1111111111111111111
