START:1,1
TOTAL_TILES:16
COIN_BAGS:
KEYS:
BLOCKS:
TELEPORTS:
1111111111111111111
1ABB111111111111111
111B111111111111111
1BBB111111111111111
1BBB111111111111111
1B11111111111111111
1B11111111111111111
1BBB111111111111111
111B111111111111111
1119111111111111111
1111111111111111111
1111111111111111111
1111111111111111111
1111111111111111111
1111111111111111111
