START:17,10
TOTAL_TILES:16
COIN_BAGS:
KEYS:
BLOCKS:
TELEPORTS:
1111111111111111111
1111111111111111111
1111111111111111111
1111111111111111111
1111111111111111111
1111111111111111111
1111111111111111111
1111111111111111111
1111111111111111111
111111111111BBBBBB1
11111111111BBBB11A1
11111111111B1111111
11111111111B1111111
1111111111BB1111111
1111111111B91111111
