START:14,4
TOTAL_TILES:16
COIN_BAGS:
KEYS:
BLOCKS:
TELEPORTS:
11111111111111BB111
11111111111111BB111
11111111111111BB111
11111111111111BBBB1
11111111111111A1BB1
111111111111111BB11
111111111111111B111
1111111111111119111
1111111111111111111
1111111111111111111
1111111111111111111
1111111111111111111
1111111111111111111
1111111111111111111
1111111111111111111
