START:13,13
TOTAL_TILES:16
COIN_BAGS:
KEYS:
BLOCKS:
TELEPORTS:
1111111111111111111
1111111111111111111
1111111111111111111
1111111111111111111
1111111111111111111
1111111111111111111
1111111111111111111
1111111111111111111
1111111111111111111
11111111BBB91111111
11111111B1111111111
11111111BB1BB111111
111111111BBBBB11111
1111111111BB1A11111
1111111111111111111
