START:7,7
TOTAL_TILES:16
COIN_BAGS:
KEYS:
BLOCKS:
TELEPORTS:
1111111111111111111
1111111111111111111
1191111111111111111
11B1111111111111111
11BBB11111111111111
11BBBBB111111111111
1111BBB111111111111
1111BBBA11111111111
1111111111111111111
1111111111111111111
1111111111111111111
1111111111111111111
1111111111111111111
1111111111111111111
1111111111111111111
