START:6,14
TOTAL_TILES:16
COIN_BAGS:
KEYS:
BLOCKS:
TELEPORTS:
1111111111111111111
1111111111111111111
1111111111111111111
1111111111111111111
1111111111111111111
1111111111111111111
1111111111111111111
1111111111111111111
1111111111119111111
111111111111BB11111
11111111111BBB11111
11111111BB1B1111111
11111111BBBB1111111
111111BBB1111111111
111111A111111111111
