START:11,0
TOTAL_TILES:16
COIN_BAGS:
KEYS:
BLOCKS:
TELEPORTS:
11111111111A1111111
11111111111BB111111
111111111111B111111
111111111111BBBB111
111111111111BB1B111
11111111111111BB111
1111111111111BB1111
1111111111119B11111
1111111111111111111
1111111111111111111
1111111111111111111
1111111111111111111
1111111111111111111
1111111111111111111
1111111111111111111
