START:7,7
TOTAL_TILES:16
COIN_BAGS:
KEYS:
BLOCKS:
TELEPORTS:
1111111111111111111
1111111111111111111
1111111111111111111
1111111111111111111
1111111111111111111
1111111111111111111
1111111111111111111
1111111ABB111111111
11111111BB111111111
11111111B1111111111
11111111BB911111111
11111111BB111111111
1111111BBB111111111
1111111BBB111111111
1111111111111111111
