START:17,10
TOTAL_TILES:16
COIN_BAGS:
KEYS:
BLOCKS:
TELEPORTS:
1111111111111111111
1111111111111111111
1111111111111111111
111111111111111B911
111111111111111BBBB
1111111111111111BBB
1111111111111111BBB
111111111111111111B
111111111111111111B
111111111111111111B
11111111111111111AB
1111111111111111111
1111111111111111111
1111111111111111111
1111111111111111111
