START:13,7
TOTAL_TILES:16
COIN_BAGS:
KEYS:
BLOCKS:
TELEPORTS:
1111111111111111111
1111111111111111111
1111111111111111111
1111111111111111111
1111111111111111111
11111111111111191BB
111111111111111BBBB
1111111111111A1111B
1111111111111BBBBBB
1111111111111111BB1
1111111111111111111
1111111111111111111
1111111111111111111
1111111111111111111
1111111111111111111
