START:14,13
TOTAL_TILES:16
COIN_BAGS:
KEYS:
BLOCKS:
TELEPORTS:
1111111111111111111
1111111111111111111
1111111111111111111
1111111111111111111
1111111111111111111
1111111111111111111
1111111111111111111
1111111111111111111
1111111111111111111
11111111119BB111111
1111111111BBB111111
111111111111B111111
1111111111BBB111111
1111111111BBBBA1111
1111111111BB1111111
