START:5,13
TOTAL_TILES:16
COIN_BAGS:
KEYS:
BLOCKS:
TELEPORTS:
1111111111111111111
1111111111111111111
1111111111111111111
1111111111111111111
1111111111111111111
1111111111111111111
1111111111119111111
1111111111BBB111111
1111111111B11111111
111111111BB11111111
11111111BB111111111
11111111B1111111111
11111BBBB1111111111
11111A1BB1111111111
1111111111111111111
