START:15,4
TOTAL_TILES:16
COIN_BAGS:
KEYS:
BLOCKS:
TELEPORTS:
1111111111111111111
1111111111111111111
1111111111111111111
1111111111111111111
111111111111111A111
111111111111111B111
111111111111111B111
111111111111111B111
111111111111111BB11
1111111111119BB1BB1
111111111111BBBBBB1
1111111111111111111
1111111111111111111
1111111111111111111
1111111111111111111
