START:0,11
TOTAL_TILES:16
COIN_BAGS:
KEYS:
BLOCKS:
TELEPORTS:
1111111111111111111
1111111111111111111
1111111111111111111
1111111111111111111
1111111111111111111
1111111111111111111
1111111111111111111
1111111111111111111
1111111111111111111
1111111111111111111
11BBB11111111111111
A1B1B11111111111111
BBBBB11111111111111
BB9B111111111111111
BB11111111111111111
