START:12,6
TOTAL_TILES:16
COIN_BAGS:
KEYS:
BLOCKS:
TELEPORTS:
1111111111111111111
1111111111111BB1111
1111111111111BBB111
111111111119BB1BB11
1111111111111BBBB11
111111111111BB11111
111111111111A111111
1111111111111111111
1111111111111111111
1111111111111111111
1111111111111111111
1111111111111111111
1111111111111111111
1111111111111111111
1111111111111111111
