START:17,14
TOTAL_TILES:16
COIN_BAGS:
KEYS:
BLOCKS:
TELEPORTS:
1111111111111111111
1111111111111111111
1111111111111111111
1111111111111111111
1111111111111111111
1111111111111111111
1111111111111111111
1111111111111111111
111111111111111BB91
111111111111111BBB1
111111111111111B111
111111111111111BB11
111111111111111BB11
11111111111111BB111
11111111111111BBBA1
