START:7,7
TOTAL_TILES:16
COIN_BAGS:
KEYS:
BLOCKS:
TELEPORTS:
1111111111111111111
1111111111111111111
1111111111111111111
1111111111111111111
1111111111111111111
1111111111111111111
1111111111111111111
1111111A11111111111
1111111B11111111111
1111111B11111111111
11111BBB11111111111
11111BBBB1111111111
11111111B1111111111
11111111BBB11111111
11111111BB911111111
