START:11,0
TOTAL_TILES:16
COIN_BAGS:
KEYS:
BLOCKS:
TELEPORTS:
11111111111A1111111
11111111BB1B1111111
11111111BB1B1111111
11111111BB1B1111111
11111111BBBB1111111
1111111191BB1111111
1111111111111111111
1111111111111111111
1111111111111111111
1111111111111111111
1111111111111111111
1111111111111111111
1111111111111111111
1111111111111111111
1111111111111111111
