START:4,7
TOTAL_TILES:16
COIN_BAGS:
KEYS:
BLOCKS:
TELEPORTS:
1111111111111111111
1191111111111111111
11BBB11111111111111
1111BBB111111111111
111111B111111111111
111111BBB1111111111
111111BBB1111111111
1111ABB111111111111
1111111111111111111
1111111111111111111
1111111111111111111
1111111111111111111
1111111111111111111
1111111111111111111
1111111111111111111
