START:18,14
TOTAL_TILES:16
COIN_BAGS:
KEYS:
BLOCKS:
TELEPORTS:
1111111111111111111
1111111111111111111
1111111111111111111
1111111111111111111
1111111111111111111
1111111111111111111
111111111111111B911
111111111111111BBBB
111111111111111111B
111111111111111111B
111111111111111111B
111111111111111111B
11111111111111111BB
1111111111111111BB1
1111111111111111BBA
