START:16,3
TOTAL_TILES:16
COIN_BAGS:
KEYS:
BLOCKS:
TELEPORTS:
111111111111BBB1111
111111111111B1B1111
111111111111BBB1111
1111111111119B1BA11
1111111111111BBB111
1111111111111BB1111
1111111111111111111
1111111111111111111
1111111111111111111
1111111111111111111
1111111111111111111
1111111111111111111
1111111111111111111
1111111111111111111
1111111111111111111
