START:3,7
TOTAL_TILES:16
COIN_BAGS:
KEYS:
BLOCKS:
TELEPORTS:
1111111111111111111
1111111111111111111
1111111111111111111
1111111111111111111
1111111111111111111
1111111111111111111
11111BB111111111111
111ABBB111111111111
111BB1B111111111111
111BBBB111111111111
111BB11111111111111
1111B91111111111111
1111111111111111111
1111111111111111111
1111111111111111111
