START:7,7
TOTAL_TILES:16
COIN_BAGS:
KEYS:
BLOCKS:
TELEPORTS:
1111111111111111111
1111111111111111111
1111111111111111111
1111111111111111111
1111111111111111111
1111111111111111111
11111111BBBB1111111
1111111ABB1B1111111
1111111BBB9BB111111
1111111111BBB111111
1111111111111111111
1111111111111111111
1111111111111111111
1111111111111111111
1111111111111111111
