START:11,9
TOTAL_TILES:16
COIN_BAGS:
KEYS:
BLOCKS:
TELEPORTS:
1111111111111111111
1111111111111111111
1111111111111111111
1111111111111111111
1111111111111111111
1111111111111111111
1111111111111111111
1111111111111111111
1111111111111111111
11111111111ABBBBB11
11111111119111BBB11
1111111111BBBBB1111
11111111111BB111111
1111111111111111111
1111111111111111111
