START:11,2
TOTAL_TILES:16
COIN_BAGS:
KEYS:
BLOCKS:
TELEPORTS:
1111111111111111111
1111111111111111111
11111111111A1111111
11111111111BB111111
111111111111BB11111
1111111111111B11111
1111111111BBBB11111
1111111111BB1111111
111111111BBB1111111
111111111B111111111
1111111119111111111
1111111111111111111
1111111111111111111
1111111111111111111
1111111111111111111
