START:5,7
TOTAL_TILES:16
COIN_BAGS:
KEYS:
BLOCKS:
TELEPORTS:
1111111111111111111
1111111111111111111
1111111111111111111
1111111111111111111
1111111111111111111
1111111111111111111
1111111111111111111
11111ABB11111111111
1111111BBBB11111111
1111111BBBB11111111
1111111BBBB11111111
1111111111B11111111
1111111111911111111
1111111111111111111
1111111111111111111
