START:16,11
TOTAL_TILES:16
COIN_BAGS:
KEYS:
BLOCKS:
TELEPORTS:
1111111111111111111
1111111111111111111
1111111111111111111
1111111111111111111
1111111111111111111
1111111111111111111
1111111111111111111
1111111111111111111
1111111111111111111
1111111111111111BB1
1111111111111111BB1
11111111111111BBAB1
11111111111111BBBB1
11111111111111BB911
11111111111111BB111
