START:5,7
TOTAL_TILES:16
COIN_BAGS:
KEYS:
BLOCKS:
TELEPORTS:
1111111111111111111
1111111111111111111
1111111111111111111
1111111111111111111
1111111111111111111
1111111111111111111
1111111B91111111111
1111BABB11111111111
1111B1B111111111111
1111BBB111111111111
1111BB1111111111111
1111BB1111111111111
1111BB1111111111111
1111111111111111111
1111111111111111111
