START:15,3
TOTAL_TILES:16
COIN_BAGS:
KEYS:
BLOCKS:
TELEPORTS:
111111111111111BBBB
111111111111111BB1B
1111111111111111B1B
111111111111111AB1B
111111111111111111B
11111111111111111BB
11111111111111111B9
1111111111111111111
1111111111111111111
1111111111111111111
1111111111111111111
1111111111111111111
1111111111111111111
1111111111111111111
1111111111111111111
