START:11,9
TOTAL_TILES:16
COIN_BAGS:
KEYS:
BLOCKS:
TELEPORTS:
1111111111111111111
1111111111111111111
1111111111111111111
1111111111111111111
1111111111111111111
1111111111111111111
1111111111111111111
1111111111111111111
1111111111111111111
1111111111BA1111111
1111111111B11111111
1111111111BBB111111
1111111111BB9111111
111111111BBBB111111
111111111BBBB111111
