START:11,9
TOTAL_TILES:16
COIN_BAGS:
KEYS:
BLOCKS:
TELEPORTS:
1111111111111111111
1111111111111111111
1111111111111111111
1111111111111111111
111111111111119B111
111111111111111B111
111111111BBBBBBB111
111111111BBB1111111
11111111111BB111111
11111111111AB111111
1111111111111111111
1111111111111111111
1111111111111111111
1111111111111111111
1111111111111111111
