START:3,5
TOTAL_TILES:16
COIN_BAGS:
KEYS:
BLOCKS:
TELEPORTS:
1111111111111111111
1111111111111111111
1111111111111111111
1111111111111111111
1111111111111111111
1BBA111111111111111
1BB1111111111111111
11BBBBB111111111111
111111BBB1111111111
111111BBB9111111111
1111111111111111111
1111111111111111111
1111111111111111111
1111111111111111111
1111111111111111111
