START:5,10
TOTAL_TILES:16
COIN_BAGS:
KEYS:
BLOCKS:
TELEPORTS:
1111111111111111111
1111111111111111111
1111111111111111111
9111111111111111111
B111111111111111111
BB11111111111111111
BB11111111111111111
B111111111111111111
B11BB11111111111111
BBBBBB1111111111111
11111A1111111111111
1111111111111111111
1111111111111111111
1111111111111111111
1111111111111111111
