START:12,12
TOTAL_TILES:16
COIN_BAGS:
KEYS:
BLOCKS:
TELEPORTS:
1111111111111111111
1111111111111111111
1111111111111111111
1111111111111111111
1111111111111111111
1111111111111111111
1111111111111111111
1111111111111111111
11111111119B1111111
11111111111B1111111
11111111111B1111111
11111111111B1111111
111111111BBBA111111
111111111BBBB111111
111111111BBBB111111
