START:5,6
TOTAL_TILES:16
COIN_BAGS:
KEYS:
BLOCKS:
TELEPORTS:
1111111111111111111
1111111111111111111
1111111111111111111
1111111111111111111
1111111111111111111
1111111111111111111
11111ABBB1111111111
111111BBBB111111111
1111111BBB111111111
1111111BBB111111111
1111111BB1111111111
1111111191111111111
1111111111111111111
1111111111111111111
1111111111111111111
