START:16,12
TOTAL_TILES:16
COIN_BAGS:
KEYS:
BLOCKS:
TELEPORTS:
1111111111111111111
1111111111111111111
1111111111111111111
1111111111111111111
1111111111111111111
1111111111111111111
1111111111111111111
1111111111111111111
1111111111111111111
1111111111111BB1111
1111111111111BB1111
111111111111BBB9111
111111111111BBBBA11
111111111111111BB11
111111111111111BB11
