START:14,10
TOTAL_TILES:16
COIN_BAGS:
KEYS:
BLOCKS:
TELEPORTS:
1111111111111111111
1111111111111111111
1111111111111111111
1111111111111111111
1111111111111111111
1111111111111111111
1111111111BB1111111
1111111111BB1111111
111111111BBBB111111
111111111BB9BBB1111
111111111BB111A1111
1111111111111111111
1111111111111111111
1111111111111111111
1111111111111111111
