START:8,8
TOTAL_TILES:16
COIN_BAGS:
KEYS:
BLOCKS:
TELEPORTS:
1111111111111111111
1111111111111111111
1111111111111111111
1111111111111111111
1111111111111111111
1111111111111111111
11111111BBB11111111
111111BBB9B11111111
11111BBBA1111111111
11111BBB11111111111
11111BB111111111111
1111111111111111111
1111111111111111111
1111111111111111111
1111111111111111111
