START:6,4
TOTAL_TILES:16
COIN_BAGS:
KEYS:
BLOCKS:
TELEPORTS:
1111111111111111111
1111111111111111111
11BB111111111111111
11BBBB1111111111111
11BB1BA111111111111
1BBB111111111111111
1B11111111111111111
1B11111111111111111
9B11111111111111111
1111111111111111111
1111111111111111111
1111111111111111111
1111111111111111111
1111111111111111111
1111111111111111111
