START:3,0
TOTAL_TILES:16
COIN_BAGS:
KEYS:
BLOCKS:
TELEPORTS:
111A111111111111111
111B111111111111111
111B19BB11111111111
111BBBBB11111111111
1111BBBB11111111111
111111BB11111111111
1111111111111111111
1111111111111111111
1111111111111111111
1111111111111111111
1111111111111111111
1111111111111111111
1111111111111111111
1111111111111111111
1111111111111111111
