START:13,9
TOTAL_TILES:16
COIN_BAGS:
KEYS:
BLOCKS:
TELEPORTS:
1111111111111111111
1111111111111111111
1111111111111111111
1111111111111111111
11111111111BBB11111
11111111111BBBBB111
111111111111BB9B111
1111111111111B11111
111111111111BB11111
111111111111BA11111
1111111111111111111
1111111111111111111
1111111111111111111
1111111111111111111
1111111111111111111
