START:10,7
TOTAL_TILES:16
COIN_BAGS:
KEYS:
BLOCKS:
TELEPORTS:
1111111111111111111
1111111111111111111
1111111111111111111
1111111111111111111
1111111111111111111
111111111111BB11111
11111111111BBB11111
1111111111AB9B11111
111111111111BBB1111
111111111111BBB1111
1111111111111BB1111
1111111111111111111
1111111111111111111
1111111111111111111
1111111111111111111
