START:0,4
TOTAL_TILES:16
COIN_BAGS:
KEYS:
BLOCKS:
TELEPORTS:
1111111111111111111
1BB1111111111111111
BBB1111111111111111
B9B1111111111111111
ABB1111111111111111
BBB1111111111111111
BBB1111111111111111
1111111111111111111
1111111111111111111
1111111111111111111
1111111111111111111
1111111111111111111
1111111111111111111
1111111111111111111
1111111111111111111
