START:12,0
TOTAL_TILES:16
COIN_BAGS:
KEYS:
BLOCKS:
TELEPORTS:
111111111BBBA111111
111111111BBB1111111
11111111111B1111111
11111111111B1111111
111111111BBB1111111
11111111BB111111111
11111111B1111111111
11111119B1111111111
1111111111111111111
1111111111111111111
1111111111111111111
1111111111111111111
1111111111111111111
1111111111111111111
1111111111111111111
