START:18,5
TOTAL_TILES:16
COIN_BAGS:
KEYS:
BLOCKS:
TELEPORTS:
1111111111111111111
1111111111111111111
1111111111111111111
1111111111111111111
1111111111111111111
111111111111111111A
111111111111111111B
111111111111111111B
111111111111111111B
11111111111111BB11B
11111111111111BBBBB
11111111111111BBB11
11111111111111B9111
1111111111111111111
1111111111111111111
