START:9,4
TOTAL_TILES:16
COIN_BAGS:
KEYS:
BLOCKS:
TELEPORTS:
1111111111111111111
1111111111111111111
1111111111111111111
1111111111111111111
111111111A111111111
11111111BB111111111
11111111BB111111111
111111BBBB111111111
111BBBB111111111111
111B1BB111111111111
1119111111111111111
1111111111111111111
1111111111111111111
1111111111111111111
1111111111111111111
