START:10,6
TOTAL_TILES:16
COIN_BAGS:
KEYS:
BLOCKS:
TELEPORTS:
1111111111111111111
1111111111111111111
1111111111111111111
1111111111111111111
1111111111111111111
11111111111BB111111
1111111111ABB111111
1111111111BBB111111
111111111111B111111
111111111111B111111
111111111111BB11111
1111111111BBBB11111
1111111111911111111
1111111111111111111
1111111111111111111
