START:8,5
TOTAL_TILES:16
COIN_BAGS:
KEYS:
BLOCKS:
TELEPORTS:
1111111111BB1911111
1111111111BBBB11111
11111111BBBBB111111
1111111BB1111111111
1111111BB1111111111
11111111A1111111111
1111111111111111111
1111111111111111111
1111111111111111111
1111111111111111111
1111111111111111111
1111111111111111111
1111111111111111111
1111111111111111111
1111111111111111111
