START:6,10
TOTAL_TILES:16
COIN_BAGS:
KEYS:
BLOCKS:
TELEPORTS:
1111111111111111111
1111111111111111111
1111111111111111111
1111111111111111111
1111111111111111111
1111111119111111111
111111111B111111111
111111BBBB111111111
111111BBBB111111111
1111111BBB111111111
111111ABBB111111111
1111111111111111111
1111111111111111111
1111111111111111111
1111111111111111111
