START:13,11
TOTAL_TILES:16
COIN_BAGS:
KEYS:
BLOCKS:
TELEPORTS:
1111111111111111111
1111111111111111111
1111111111111111111
1111111111111111111
1111111111111111111
1111111111111111111
1111111111111111111
1111111111111111111
1111111111111111111
1111111911111111111
111111BB11111111111
111111BBBBBB1A11111
11111111111B1B11111
11111111111BBB11111
111111111111BB11111
