START:6,12
TOTAL_TILES:16
COIN_BAGS:
KEYS:
BLOCKS:
TELEPORTS:
1111111111111111111
1111111111111111111
1111111111111111111
1111111111111111111
1111111111111111111
1111111111111111111
1111111111111111111
1111111111111111111
1111111111111111111
11111111BB111111111
111111BBBBB11111111
111111BB1BB11111111
111111AB1BB11111111
1111111119B11111111
1111111111111111111
