START:8,8
TOTAL_TILES:16
COIN_BAGS:
KEYS:
BLOCKS:
TELEPORTS:
1111111111111111111
1111111111111111111
1111111111111111111
1111111111111111111
1111111111111111111
1111111111111111111
1111111111111111111
1111111BB1111111111
111111BBA1111111111
11111BB1B9111111111
1111BB1BB1111111111
1111BBBB11111111111
1111111111111111111
1111111111111111111
1111111111111111111
