START:9,7
TOTAL_TILES:16
COIN_BAGS:
KEYS:
BLOCKS:
TELEPORTS:
1111111111111111111
1111111111111111111
1111111111111111111
1111111111111111111
1111111111111111111
1111111111111111111
1111111111111111111
111111BB1A111111111
111111BBBB111111111
111111BB11111111111
111111BB11111111111
11111BB111111111111
11111BB111111111111
111119B111111111111
1111111111111111111
