START:8,6
TOTAL_TILES:16
COIN_BAGS:
KEYS:
BLOCKS:
TELEPORTS:
1111111111111111111
1111111111111111111
1111111111111111111
1111111111111111111
1111111111111111111
1111111111111111111
11111111ABB11111111
1111111111BB1111111
11111111111BBB11111
1111111111111BBBB11
1111111111111111B11
1111111111111111BB1
11111111111111119B1
1111111111111111111
1111111111111111111
