START:7,11
TOTAL_TILES:16
COIN_BAGS:
KEYS:
BLOCKS:
TELEPORTS:
1111111111111111111
1111111111111111111
1111111111111111111
1111111111111111111
1111111111111111111
1111111111111111111
1111111111111111111
11BB111111111111111
11BBBBB111111111111
11BBB1BB11111111111
119BB11B11111111111
1111111A11111111111
1111111111111111111
1111111111111111111
1111111111111111111
