START:12,5
TOTAL_TILES:16
COIN_BAGS:
KEYS:
BLOCKS:
TELEPORTS:
111111111111111BBB1
11111111111111BB1B1
11111111111111B11B1
111111111111BBB11B1
111111111111B119BB1
111111111111A111111
1111111111111111111
1111111111111111111
1111111111111111111
1111111111111111111
1111111111111111111
1111111111111111111
1111111111111111111
1111111111111111111
1111111111111111111
