START:0,11
TOTAL_TILES:16
COIN_BAGS:
KEYS:
BLOCKS:
TELEPORTS:
1111111111111111111
1111111111111111111
1111111111111111111
1111111111111111111
1111111111111111111
BB11111111111111111
BB11111111111111111
9BBB111111111111111
1BBB111111111111111
BBBB111111111111111
B111111111111111111
A111111111111111111
1111111111111111111
1111111111111111111
1111111111111111111
