START:16,7
TOTAL_TILES:16
COIN_BAGS:
KEYS:
BLOCKS:
TELEPORTS:
11111111111119BB111
11111111111111BB111
111111111111BBB1111
111111111111BB11111
1111111111111BB1111
11111111111111B1111
11111111111111B1111
11111111111111BBA11
1111111111111111111
1111111111111111111
1111111111111111111
1111111111111111111
1111111111111111111
1111111111111111111
1111111111111111111
