START:16,7
TOTAL_TILES:16
COIN_BAGS:
KEYS:
BLOCKS:
TELEPORTS:
11111111111119BBBBB
1111111111111111BBB
111111111111111111B
111111111111111111B
111111111111111111B
111111111111111111B
11111111111111111BB
1111111111111111AB1
1111111111111111111
1111111111111111111
1111111111111111111
1111111111111111111
1111111111111111111
1111111111111111111
1111111111111111111
