START:18,0
TOTAL_TILES:15
COIN_BAGS:
KEYS:
BLOCKS:
TELEPORTS:
11111111111111111BA
11111111111111111BB
111111111111111119B
11111111111111111BB
1111111111111111BBB
1111111111111111BBB
11111111111111111BB
1111111111111111111
1111111111111111111
1111111111111111111
1111111111111111111
1111111111111111111
1111111111111111111
1111111111111111111
1111111111111111111
