START:12,6
TOTAL_TILES:16
COIN_BAGS:
KEYS:
BLOCKS:
TELEPORTS:
1111111111111111111
1111111111111111111
1111111111111111111
1111111111111111111
1111111111111111111
11111111111BB111111
11111111111BA111111
1111111111BB1111111
1111111111BBBB11111
11111111111BBBB1111
1111111111119BB1111
1111111111111111111
1111111111111111111
1111111111111111111
1111111111111111111
