START:12,8
TOTAL_TILES:16
COIN_BAGS:
KEYS:
BLOCKS:
TELEPORTS:
1111111111111111111
1111111111111111111
1111111111111111111
1111111111111111111
1111111111111111111
1111111111111111111
1111111111111111111
1111111111111BB1111
111111111111ABBB111
111111111111BBBBB91
111111111111BBBBB11
1111111111111111111
1111111111111111111
1111111111111111111
1111111111111111111
