START:12,12
TOTAL_TILES:16
COIN_BAGS:
KEYS:
BLOCKS:
TELEPORTS:
1111111111111111111
1111111111111111111
1111111111111111111
1111111111111111111
1111111111111111111
1111111111111111111
1111111111111111111
111111111BBBB111111
111111111BBBB111111
1111111119B11111111
1111111111BBBB11111
111111111111BB11111
111111111111A111111
1111111111111111111
1111111111111111111
