START:5,9
TOTAL_TILES:16
COIN_BAGS:
KEYS:
BLOCKS:
TELEPORTS:
1111111111111111111
1111111111111111111
1111111111111111111
1111111111111111111
1111111111111111111
1111111111111111111
1111111111111111111
1111111111111111111
1111BB1111111111111
1111BA1111111111111
1111BB1111111111111
11111BBBBBB11111111
111111119BB11111111
11111111BB111111111
1111111111111111111
