START:9,6
TOTAL_TILES:16
COIN_BAGS:
KEYS:
BLOCKS:
TELEPORTS:
1111111111111111111
1111111111111111111
1111111111111111111
1111111111111111111
1111111111111111111
111111111BBBB111111
111111111A11BB11111
1111111111111B11111
1111111111111B11111
1111111111111BB1111
11111111111111B1111
11111111111111BB111
11111111111119BB111
1111111111111111111
1111111111111111111
