START:4,11
TOTAL_TILES:16
COIN_BAGS:
KEYS:
BLOCKS:
TELEPORTS:
1111111111111111111
1111111111111111111
1111111111111111111
1111111111111111111
1111111111111111111
1111111111111111111
1111111111111111111
1111111111111111111
11111119BBB11111111
1111BBBBBBBB1111111
1111B1111BBB1111111
1111A11111111111111
1111111111111111111
1111111111111111111
1111111111111111111
