START:5,14
TOTAL_TILES:16
COIN_BAGS:
KEYS:
BLOCKS:
TELEPORTS:
1111111111111111111
1111111111111111111
1111111111111111111
1111111111111111111
1111111111111111111
1111111111111111111
1111111111111111111
1111111111111111111
1111BB1111111111111
11119B1111111111111
11111BB111111111111
11111BB111111111111
111BBB1111111111111
111BBB1111111111111
111BBA1111111111111
