START:8,2
TOTAL_TILES:16
COIN_BAGS:
KEYS:
BLOCKS:
TELEPORTS:
1111111111111111111
1111111111111111111
11111111A1111111111
11111111B1111111111
11111111B1111111111
11111111B1111111111
1111111BB1111111111
1111111BB1111111111
1111119BB1111111111
111111BBB1111111111
111111BBB1111111111
1111111111111111111
1111111111111111111
1111111111111111111
1111111111111111111
