START:3,2
TOTAL_TILES:16
COIN_BAGS:
KEYS:
BLOCKS:
TELEPORTS:
1111111111111111111
1111111111111111111
11BA111111111111111
11B1111111111111111
11B1111111111111111
11B1111111111111111
11B1111111111111111
11B1111111111111111
11BB111111111111111
111B111111111111111
111BB11111111111111
111BB11111111111111
111BB91111111111111
1111111111111111111
1111111111111111111
