START:12,10
TOTAL_TILES:16
COIN_BAGS:
KEYS:
BLOCKS:
TELEPORTS:
1111111111111111111
1111111111111111111
1111111111111111111
1111111111111111111
1111111111111111111
1111111111111BBB111
1111111111111BBB111
1111111111BBBBB9111
1111111111BB1111111
11111111111BB111111
111111111111A111111
1111111111111111111
1111111111111111111
1111111111111111111
1111111111111111111
