START:13,4
TOTAL_TILES:16
COIN_BAGS:
KEYS:
BLOCKS:
TELEPORTS:
1111111111111111111
111111111111111BBB1
1111111111111119BB1
1111111111111111BB1
1111111111111AB11B1
11111111111111BB1B1
111111111111111BBB1
1111111111111111111
1111111111111111111
1111111111111111111
1111111111111111111
1111111111111111111
1111111111111111111
1111111111111111111
1111111111111111111
