START:17,13
TOTAL_TILES:16
COIN_BAGS:
KEYS:
BLOCKS:
TELEPORTS:
1111111111111111111
1111111111111111111
1111111111111111111
1111111111111111111
1111111111111111111
1111111111111111111
1111111111119111111
111111111111B111111
111111111111BB11111
1111111111111B11111
1111111111111BBB111
11111111111111BB111
11111111111111BBB11
1111111111111111BA1
1111111111111111BB1
