START:4,1
TOTAL_TILES:16
COIN_BAGS:
KEYS:
BLOCKS:
TELEPORTS:
1111111111111111111
1111A11111111111111
1111BB1111111111111
11111BBB11111111111
1111111B111BB111111
1111111BBB1B9111111
111111111BBB1111111
1111111111111111111
1111111111111111111
1111111111111111111
1111111111111111111
1111111111111111111
1111111111111111111
1111111111111111111
1111111111111111111
