START:5,1
TOTAL_TILES:16
COIN_BAGS:
KEYS:
BLOCKS:
TELEPORTS:
1111111111111111111
11111A1111111111111
11111BB111111111111
11111BB111111111111
11111B1111111111111
11111BB111111111111
111111B111111111111
111111B111111111111
111111B111111111111
111111BBB1111111111
1111119BB1111111111
1111111111111111111
1111111111111111111
1111111111111111111
1111111111111111111
