START:5,3
TOTAL_TILES:16
COIN_BAGS:
KEYS:
BLOCKS:
TELEPORTS:
1111111111111111111
1111111111111111111
1111111111111111111
111BBA1111111111111
111B111111111111111
111B111111111111111
11BB111111111111111
11B1111111111111111
11BBB11111111111111
1111B11111111111111
1111B11111111111111
1111B11111111111111
1111BB1111111111111
1111191111111111111
1111111111111111111
