START:4,7
TOTAL_TILES:16
COIN_BAGS:
KEYS:
BLOCKS:
TELEPORTS:
1111111111111111111
1111111111111111111
1111111111111111111
1111111111111111111
1111111111111111111
1111111111111111111
1111111111111111111
1111ABB111111111111
111111B11119B111111
111111BB111BB111111
1111111B111B1111111
1111111BBBBB1111111
1111111111111111111
1111111111111111111
1111111111111111111
