START:5,4
TOTAL_TILES:16
COIN_BAGS:
KEYS:
BLOCKS:
TELEPORTS:
1111111111111111111
1111111111111111111
1111111111111111111
1111111111111111111
11111A1911111111111
1111BBBB11111111111
1111BBB111111111111
1111BBB111111111111
1111B1B111111111111
1111BBB111111111111
1111111111111111111
1111111111111111111
1111111111111111111
1111111111111111111
1111111111111111111
