START:17,8
TOTAL_TILES:16
COIN_BAGS:
KEYS:
BLOCKS:
TELEPORTS:
1111111111111111111
1111111111111111111
1111111111111111111
1111111111111111111
1111111111111111111
1111111111111111111
1111111111111111111
11111111111111BBBB1
11111111111111BBBA1
11111111111111BBB11
11111111111111B1111
11111111111111B1111
1111111111111BB1111
1111111111119B11111
1111111111111111111
