START:17,9
TOTAL_TILES:16
COIN_BAGS:
KEYS:
BLOCKS:
TELEPORTS:
11111111111111119BB
111111111111111111B
11111111111111111BB
11111111111111111BB
111111111111111111B
11111111111111111BB
11111111111111111B1
1111111111111111BB1
1111111111111111B11
1111111111111111BA1
1111111111111111111
1111111111111111111
1111111111111111111
1111111111111111111
1111111111111111111
