START:14,5
TOTAL_TILES:16
COIN_BAGS:
KEYS:
BLOCKS:
TELEPORTS:
1111111111111111111
1111111111BBB111111
1111111111BBBB11111
11111111111B1B91111
11111111111B1111111
11111111111B11A1111
11111111111BBBB1111
1111111111111111111
1111111111111111111
1111111111111111111
1111111111111111111
1111111111111111111
1111111111111111111
1111111111111111111
1111111111111111111
