START:2,6
TOTAL_TILES:16
COIN_BAGS:
KEYS:
BLOCKS:
TELEPORTS:
BB11111111111111111
BB11111111111111111
9B11111111111111111
BB11111111111111111
BBB1111111111111111
BBB1111111111111111
BBA1111111111111111
1111111111111111111
1111111111111111111
1111111111111111111
1111111111111111111
1111111111111111111
1111111111111111111
1111111111111111111
1111111111111111111
