START:3,8
TOTAL_TILES:16
COIN_BAGS:
KEYS:
BLOCKS:
TELEPORTS:
1111111111111111111
1111111111111111111
1111111111111111111
1111111111111111111
1111111111111111111
1111111111111111111
1111111111111111111
1111111111111111111
111A111111111111111
111B111111111111111
111BBBBBB1111111111
11111111BBBB1111111
11111111111BB111111
111111111111B111111
111111111111B911111
