START:7,5
TOTAL_TILES:16
COIN_BAGS:
KEYS:
BLOCKS:
TELEPORTS:
1111BB1111111111111
1111BBBBB9111111111
1111BBBBBB111111111
1111111B11111111111
1111111B11111111111
1111111A11111111111
1111111111111111111
1111111111111111111
1111111111111111111
1111111111111111111
1111111111111111111
1111111111111111111
1111111111111111111
1111111111111111111
1111111111111111111
