START:12,11
TOTAL_TILES:16
COIN_BAGS:
KEYS:
BLOCKS:
TELEPORTS:
1111111111111111111
1111111111111111111
1111111111111111111
1111111111111111111
1111111111111111111
1111111111111111111
1111111111111111111
1111111111111111111
1111111111111111111
1111111111BB1111111
1111111BBBBBB111111
1111111B1111A111111
11111BBB11111111111
11111BB111111111111
111111B911111111111
