START:9,1
TOTAL_TILES:16
COIN_BAGS:
KEYS:
BLOCKS:
TELEPORTS:
1111111BB1111111111
111111BBBA111111111
111111BBB1111111111
111111BBB1111111111
111111BB11111111111
1111111B11111111111
1111111B91111111111
1111111111111111111
1111111111111111111
1111111111111111111
1111111111111111111
1111111111111111111
1111111111111111111
1111111111111111111
1111111111111111111
