START:17,10
TOTAL_TILES:16
COIN_BAGS:
KEYS:
BLOCKS:
TELEPORTS:
1111111111111111111
1111111111111111111
1111111111111111111
1111111111111111111
1111111111111111111
1111111111111111111
1111111111111111111
1111111111111BB1111
11111111111BBBB1111
11111111111B11B1111
11111111111911B11A1
11111111111111B1BB1
11111111111111BBB11
1111111111111111111
1111111111111111111
