START:9,2
TOTAL_TILES:16
COIN_BAGS:
KEYS:
BLOCKS:
TELEPORTS:
1111111111111111111
1111111111111111111
1111111BBA111111111
111111BBBB111111111
111111BB11111111111
11111BBB11111111111
11111B1111111111111
11111B1111111111111
11111BB911111111111
1111111111111111111
1111111111111111111
1111111111111111111
1111111111111111111
1111111111111111111
1111111111111111111
