START:9,7
TOTAL_TILES:16
COIN_BAGS:
KEYS:
BLOCKS:
TELEPORTS:
11111111111BBBBB911
1111111111BB1111111
111111111BB11111111
11111111BB111111111
11111111B1111111111
11111111B1111111111
11111111B1111111111
11111111BA111111111
1111111111111111111
1111111111111111111
1111111111111111111
1111111111111111111
1111111111111111111
1111111111111111111
1111111111111111111
