START:7,0
TOTAL_TILES:16
COIN_BAGS:
KEYS:
BLOCKS:
TELEPORTS:
1111111A11111111111
11111BBB11111111111
11111BBB11111111111
11111B1111111111111
11BBBB1111111111111
11BBBB9111111111111
1111111111111111111
1111111111111111111
1111111111111111111
1111111111111111111
1111111111111111111
1111111111111111111
1111111111111111111
1111111111111111111
1111111111111111111
