START:11,9
TOTAL_TILES:16
COIN_BAGS:
KEYS:
BLOCKS:
TELEPORTS:
1111111111111111111
1111111111111111111
1111111111111111111
1111111111111111111
1111111111111111111
1111111111111111111
1111111BBBBB1111111
1111111B1BBBB111111
111111BB111BB111111
111119B1111A1111111
1111111111111111111
1111111111111111111
1111111111111111111
1111111111111111111
1111111111111111111
