START:3,3
TOTAL_TILES:16
COIN_BAGS:
KEYS:
BLOCKS:
TELEPORTS:
1111111111111111111
1111111111111111111
1111111111111111111
111A111111111111111
111B111111111111111
111BBBBB11111111111
1111111B11111111111
1111111B11111111111
111111BB11111111111
111111BB19111111111
1111111BBB111111111
1111111111111111111
1111111111111111111
1111111111111111111
1111111111111111111
