START:2,6
TOTAL_TILES:16
COIN_BAGS:
KEYS:
BLOCKS:
TELEPORTS:
1111111111111111111
1111111111111111111
1111111111111111111
1111111111111111111
1111111111111111111
1111111111111111111
11AB111111111111111
111BB11111111111111
1111B19B11111111111
1111B11BB1111111111
1111BB11B1111111111
11111BBBB1111111111
1111111111111111111
1111111111111111111
1111111111111111111
