START:18,1
TOTAL_TILES:16
COIN_BAGS:
KEYS:
BLOCKS:
TELEPORTS:
1111111111111111111
1111111111111111BBA
1111111111111111BB1
11111111111111111B1
11111111111111111B1
111111111111111BBB1
111111111111BBBB111
1111111111119BB1111
1111111111111111111
1111111111111111111
1111111111111111111
1111111111111111111
1111111111111111111
1111111111111111111
1111111111111111111
