START:2,8
TOTAL_TILES:16
COIN_BAGS:
KEYS:
BLOCKS:
TELEPORTS:
1111111111111111111
1911111111111111111
1BBB111111111111111
111BB11111111111111
1111B11111111111111
1111B11111111111111
111BB11111111111111
111BB11111111111111
11ABB11111111111111
11BB111111111111111
1111111111111111111
1111111111111111111
1111111111111111111
1111111111111111111
1111111111111111111
