START:5,10
TOTAL_TILES:16
COIN_BAGS:
KEYS:
BLOCKS:
TELEPORTS:
1111111111111111111
1111111111111111111
1111111111111111111
1111111111111111111
1111111111111111111
1111111111111111111
1111111111111111111
1111111111111111111
1111111111111111111
1111111BB1111111111
11111ABBB1111111111
111111BBB1111111111
11111111BBBBB111111
111111111111BB91111
1111111111111111111
