START:16,7
TOTAL_TILES:16
COIN_BAGS:
KEYS:
BLOCKS:
TELEPORTS:
1111111111111111111
1111111111111111111
1111111111111111111
1111111111111111111
111111111111111BB11
1111111111111BBBBBB
1111111111111BBB11B
111111111111111BA1B
111111111111111111B
1111111111111111119
1111111111111111111
1111111111111111111
1111111111111111111
1111111111111111111
1111111111111111111
