START:14,7
TOTAL_TILES:16
COIN_BAGS:
KEYS:
BLOCKS:
TELEPORTS:
1111111111111111111
1111111111111111111
1111111111111111111
1111111111111111111
1111111111111111111
1111111111111111111
1111111111111BBBBB1
1111111111111BA11B1
111111111111111BBB1
111111111111111BBB1
1111111111111119BB1
1111111111111111111
1111111111111111111
1111111111111111111
1111111111111111111
