START:10,9
TOTAL_TILES:16
COIN_BAGS:
KEYS:
BLOCKS:
TELEPORTS:
1111111111111111111
1111111111111111111
1111111111111111111
1111111111111111111
1111111111111111111
1111111111111111111
1111111111111111111
1111111111111111111
1111111111111111111
1111111111A11111111
1111111111BBBBB1111
1111111111BBBBB1111
1111111111B9BB11111
1111111111BB1111111
1111111111111111111
