START:13,0
TOTAL_TILES:16
COIN_BAGS:
KEYS:
BLOCKS:
TELEPORTS:
1111111111111A11111
111111111111BB11111
111111111111BB11111
111111111111BB11111
111111111111B111111
111111111111B111111
111111111111B111111
1111111111BBB111111
1111111119BBB111111
1111111111111111111
1111111111111111111
1111111111111111111
1111111111111111111
1111111111111111111
1111111111111111111
