START:1,2
TOTAL_TILES:16
COIN_BAGS:
KEYS:
BLOCKS:
TELEPORTS:
1111111111111111111
1111111111111111111
1ABBB11111111111111
1111B11111111111111
1111B11111111111111
1191B11111111111111
11BBB11111111111111
11BBB11111111111111
11BBB11111111111111
1111111111111111111
1111111111111111111
1111111111111111111
1111111111111111111
1111111111111111111
1111111111111111111
