START:8,5
TOTAL_TILES:16
COIN_BAGS:
KEYS:
BLOCKS:
TELEPORTS:
111111111BBB1111111
111111111BBB1111111
1111111111BBB111111
1111111111B1BB11111
111111111BB11911111
11111111AB111111111
1111111111111111111
1111111111111111111
1111111111111111111
1111111111111111111
1111111111111111111
1111111111111111111
1111111111111111111
1111111111111111111
1111111111111111111
