START:9,1
TOTAL_TILES:16
COIN_BAGS:
KEYS:
BLOCKS:
TELEPORTS:
11111111111BBBBB111
111111111ABB111BBB1
11111111111111111B1
11111111111111111B1
11111111111111111B1
11111111111111111B1
11111111111111111B1
1111111111111111191
1111111111111111111
1111111111111111111
1111111111111111111
1111111111111111111
1111111111111111111
1111111111111111111
1111111111111111111
