START:16,0
TOTAL_TILES:16
COIN_BAGS:
KEYS:
BLOCKS:
TELEPORTS:
1111111111111111ABB
111111111111111111B
111111111111111111B
11111111111111111BB
11111111111111111BB
111111111111111111B
111111111111111111B
1111111111111119BBB
11111111111111111BB
1111111111111111111
1111111111111111111
1111111111111111111
1111111111111111111
1111111111111111111
1111111111111111111
