START:17,9
TOTAL_TILES:16
COIN_BAGS:
KEYS:
BLOCKS:
TELEPORTS:
1111111111111111111
1111111111111111111
1111111111111111111
1111111111191111111
11111111111B1111111
11111111111BB111111
11111111111BB111111
11111111111B1111111
11111111111B11BB111
11111111111BBBBBBA1
1111111111111111111
1111111111111111111
1111111111111111111
1111111111111111111
1111111111111111111
