START:8,11
TOTAL_TILES:16
COIN_BAGS:
KEYS:
BLOCKS:
TELEPORTS:
1111111111111111111
1111111111111111111
1111111111111111111
1111111111111111111
1111111111111111111
1111111111111111111
1111111111111111111
1111111111111111111
1111111111111111111
1191111111111111111
1BB1111111111111111
1BB11111A1111111111
11B1111BB1111111111
11BBBB1B11111111111
11111BBB11111111111
