START:8,6
TOTAL_TILES:16
COIN_BAGS:
KEYS:
BLOCKS:
TELEPORTS:
1111111111111111111
1111111111111111111
111111BB91111111111
1111BBB111111111111
1111BB1111111111111
11111B1BB1111111111
11111BBBA1111111111
11111BB111111111111
1111111111111111111
1111111111111111111
1111111111111111111
1111111111111111111
1111111111111111111
1111111111111111111
1111111111111111111
