START:12,9
TOTAL_TILES:16
COIN_BAGS:
KEYS:
BLOCKS:
TELEPORTS:
1111111111111111111
1111111111111111111
1111111111111111111
1111111111111111111
1111111111111111111
1111111111111111111
1111111111111111111
1111111111111111111
1111111111111111111
111111111111A111111
111111111111B111111
111111111111B111111
111111111111B111111
111191111BBBB111111
1111BBBBBBBB1111111
