START:1,10
TOTAL_TILES:15
COIN_BAGS:
KEYS:
BLOCKS:
TELEPORTS:
1111111111111111111
1111111111111111111
1111111111111111111
1111111111111111111
1111111111111111111
1111111111111111111
1111111111111111111
1111111111111111111
BB11111111111111111
BBB1111111111111111
BAB1111111111111111
BBB1111111111111111
BBB1111111111111111
19B1111111111111111
1111111111111111111
