START:8,7
TOTAL_TILES:16
COIN_BAGS:
KEYS:
BLOCKS:
TELEPORTS:
111119BBB1111111111
111111BBB1111111111
11111111B1111111111
11111111BB111111111
1111111BBB111111111
1111111B11111111111
1111111B11111111111
1111111BA1111111111
1111111111111111111
1111111111111111111
1111111111111111111
1111111111111111111
1111111111111111111
1111111111111111111
1111111111111111111
