START:15,2
TOTAL_TILES:16
COIN_BAGS:
KEYS:
BLOCKS:
TELEPORTS:
111111111111111BBBB
111111111111111BBBB
111111111111111A11B
111111111111111111B
111111111111111111B
111111111111111111B
111111111111111111B
11111111111111119BB
1111111111111111111
1111111111111111111
1111111111111111111
1111111111111111111
1111111111111111111
1111111111111111111
1111111111111111111
