START:16,13
TOTAL_TILES:16
COIN_BAGS:
KEYS:
BLOCKS:
TELEPORTS:
1111111111111111111
1111111111111111111
1111111111111111111
1111111111111111111
1111111111111111111
1111111111111111111
1111111111111111111
1111111111111111111
1111111111111111191
111111111111111BBB1
11111111111111BB111
11111111111111BB111
1111111111111BBB111
1111111111111BBBA11
111111111111111BB11
