START:9,12
TOTAL_TILES:16
COIN_BAGS:
KEYS:
BLOCKS:
TELEPORTS:
1111111111111111111
1111111111111111111
1111111111111111111
1111111111111111111
1111111111111111111
1111111111111111111
1111111111111111111
1111111111111111111
1111111111111111111
1111111BBBB11111111
111111BBBBB11111111
111111BB9BB11111111
1111111BBA111111111
1111111111111111111
1111111111111111111
