START:6,13
TOTAL_TILES:16
COIN_BAGS:
KEYS:
BLOCKS:
TELEPORTS:
1111111111111111111
1111111111111111111
1111111111111111111
1111111111111111111
1111111111111111111
1111111111111111111
1111111111111111111
1111111111111111111
1111111111111911111
11111111111BBB11111
11111111111B1111111
11111111111B1111111
11111111111B1111111
111111ABBBBBB111111
1111111111BBB111111
