START:10,12
TOTAL_TILES:16
COIN_BAGS:
KEYS:
BLOCKS:
TELEPORTS:
1111111111111111111
1111111111111111111
1111111111111111111
1111111111111111111
1111111111111111111
1111111111111111111
1111111111111111111
1111111111111111111
1111111111111111111
1111111111111111191
1111111111111111BB1
1111111111111111B11
1111111111A1111BB11
1111111111BBBBBB111
111111111111BBBB111
