START:14,12
TOTAL_TILES:16
COIN_BAGS:
KEYS:
BLOCKS:
TELEPORTS:
1111111111111111111
1111111111111111111
1111111111111111111
1111111111111111111
1111111111111111111
1111111111111BB1111
111111111111BB91111
111111111111BBB1111
1111111111111BB1111
1111111111111BB1111
1111111111111BB1111
1111111111111BB1111
11111111111111A1111
1111111111111111111
1111111111111111111
