START:11,10
TOTAL_TILES:16
COIN_BAGS:
KEYS:
BLOCKS:
TELEPORTS:
1111111111111111111
1111111111111111111
1111111111111111111
1111111111111111111
1111111111111111111
1111111111111111111
1111111111111111111
1111111111111111111
1111111111111111111
1111111111BBBB11111
1111111111BABB11111
11111111119BB111111
11111111111BBB11111
11111111111BBB11111
1111111111111111111
