START:8,4
TOTAL_TILES:16
COIN_BAGS:
KEYS:
BLOCKS:
TELEPORTS:
1111111111911111111
1111111111B11111111
1111111111B11111111
111111111BB11111111
11111111AB111111111
11111111BB111111111
11111111BB111111111
11111111BB111111111
11111111BB111111111
11111111BB111111111
1111111111111111111
1111111111111111111
1111111111111111111
1111111111111111111
1111111111111111111
