START:2,12
TOTAL_TILES:16
COIN_BAGS:
KEYS:
BLOCKS:
TELEPORTS:
1111111111111111111
1111111111111111111
1111111111111111111
1119111111111111111
111B111111111111111
11BB111111111111111
BBB1111111111111111
B111111111111111111
B111111111111111111
B111111111111111111
B111111111111111111
B111111111111111111
BBA1111111111111111
BB11111111111111111
1111111111111111111
