START:5,13
TOTAL_TILES:16
COIN_BAGS:
KEYS:
BLOCKS:
TELEPORTS:
1111111111111111111
1111111111111111111
1111111111111111111
1111111111111111111
1111111111111111111
1111111111111111111
1111111111111111111
1911111111111111111
1BBB111111111111111
11BB111111111111111
11B1111111111111111
1BB1111111111111111
1BBBBB1111111111111
11BB1A1111111111111
1111111111111111111
