START:16,8
TOTAL_TILES:16
COIN_BAGS:
KEYS:
BLOCKS:
TELEPORTS:
1111111111111111111
1111111111111111111
1111111111111111111
1111111111111111111
1111111111111111111
1111111111111111111
1111111111111111111
1111111111111111111
111111111111BBBBA11
111111111111BBBB111
1111111111111B11111
1111111111111B11111
1111111111119BB1111
111111111111BBB1111
1111111111111111111
