START:12,7
TOTAL_TILES:16
COIN_BAGS:
KEYS:
BLOCKS:
TELEPORTS:
1111111111111111111
1111111111111111111
1111111111111111111
1111111111111111111
1111111111111111111
1111111111111111111
1111111111111111111
11111111111BA111111
111111111BBB1111111
111111111BBB9111111
111111111BBB1111111
111111111BBB1111111
111111111BB11111111
1111111111111111111
1111111111111111111
