START:1,9
TOTAL_TILES:16
COIN_BAGS:
KEYS:
BLOCKS:
TELEPORTS:
1111111111111111111
1111111111111111111
1111111111111111111
1111111111111111111
1111111111111111111
1111111111111111111
1111111111111111111
1111111111111111111
1111111111111111111
1ABBB111BB111111111
1111BBBBBB111111111
1111111BB9111111111
1111111BB1111111111
1111111111111111111
1111111111111111111
