START:5,13
TOTAL_TILES:16
COIN_BAGS:
KEYS:
BLOCKS:
TELEPORTS:
1111111111111111111
1111111111111111111
1111111111111111111
1111111111111111111
1111111111111111111
1111111111111111111
1111111111111111111
11B9111111111111111
11B1111111111111111
11B1111111111111111
11BB111111111111111
111BB11111111111111
11BBB11111111111111
11BBBA1111111111111
11BB111111111111111
