START:18,6
TOTAL_TILES:16
COIN_BAGS:
KEYS:
BLOCKS:
TELEPORTS:
1111111111111111111
1111111111111111111
1111111111111111111
1111111111111111111
1111111111111111111
1111111111111111111
111111111111111111A
111111111111111111B
11111111111111111BB
1111111111111111BB1
1111111111111111B11
111111111111111BB11
111111111111111BB11
11111111111111BBB11
111111111111119BB11
