START:16,3
TOTAL_TILES:16
COIN_BAGS:
KEYS:
BLOCKS:
TELEPORTS:
1111111111111111111
1111111111111111111
1111111111111111111
1111111111111111A11
1111111111111111BBB
1111111111111111BB9
1111111111111111BBB
1111111111111111BBB
11111111111111111BB
11111111111111111BB
1111111111111111111
1111111111111111111
1111111111111111111
1111111111111111111
1111111111111111111
