START:13,14
TOTAL_TILES:14
COIN_BAGS:
KEYS:
BLOCKS:
TELEPORTS:
1111111111111111111
1111111111111111111
1111111111111111111
1111111111111111111
1111111111111111111
1111111111111111111
1111111111111111111
1111111111111111111
1111111111111111111
111111111B911111111
111111111B111111111
111111111BB11111111
1111111111BB1111111
11111111111BBBB1111
11111111111BBAB1111
