START:6,6
TOTAL_TILES:16
COIN_BAGS:
KEYS:
BLOCKS:
TELEPORTS:
1111111111111111111
1111111111111111111
1111111111111111111
1111111111111111111
1111111111111111111
1111111111111111111
111111ABB1111111111
11111111BBBB1111111
111111111BBB1111111
111111111BBB1111111
111111111BB11111111
1111111111B91111111
1111111111111111111
1111111111111111111
1111111111111111111
