START:3,8
TOTAL_TILES:16
COIN_BAGS:
KEYS:
BLOCKS:
TELEPORTS:
1111111111111111111
1111111111111111111
1111111111111111111
1111111111111111111
1111111111111111111
1111111111111111111
11111BB111111111111
11111BBB11111111111
111AB9BB11111111111
1111B1B111111111111
1111BBB111111111111
1111BB1111111111111
1111111111111111111
1111111111111111111
1111111111111111111
