START:14,6
TOTAL_TILES:16
COIN_BAGS:
KEYS:
BLOCKS:
TELEPORTS:
1111111111111111111
1111111111111111111
1111111111111111111
1111111111111111111
1111111111111111111
1111111111111111111
11111111111111A1111
11111111111111BBB11
1111111111111111B11
1111111111111111B11
1111111111111111B11
1111111111111111B11
11111111111111BBB11
111111111119BBB1111
111111111111BB11111
