START:6,6
TOTAL_TILES:16
COIN_BAGS:
KEYS:
BLOCKS:
TELEPORTS:
1111111111111111111
1111111111111111111
11BB111111111111111
BBBBBBB111111111111
B11111B111111111111
B11111B111111111111
B11111A111111111111
B111111111111111111
9111111111111111111
1111111111111111111
1111111111111111111
1111111111111111111
1111111111111111111
1111111111111111111
1111111111111111111
