START:7,8
TOTAL_TILES:16
COIN_BAGS:
KEYS:
BLOCKS:
TELEPORTS:
1111111111111111111
11111111111B9111111
11111111111BB111111
1111111111BBB111111
1111111111BB1111111
11111111111B1111111
1111111111BB1111111
111111111BB11111111
1111111ABB111111111
1111111111111111111
1111111111111111111
1111111111111111111
1111111111111111111
1111111111111111111
1111111111111111111
