START:9,2
TOTAL_TILES:16
COIN_BAGS:
KEYS:
BLOCKS:
TELEPORTS:
1111111111111111111
1111111111111111111
111111111A111111111
111111111B111111111
11111111BB111111111
1111111BB1111111111
111111BB11111111111
111111B111111111111
111BBBB111111111111
111BBB1111111111111
1119111111111111111
1111111111111111111
1111111111111111111
1111111111111111111
1111111111111111111
