START:4,9
TOTAL_TILES:16
COIN_BAGS:
KEYS:
BLOCKS:
TELEPORTS:
1111111111111111111
1111111111111111111
1111111111111111111
1191111111111111111
11B1111111111111111
11BBB11111111111111
1BBBB11111111111111
1BBBB11111111111111
1BB1B11111111111111
1111A11111111111111
1111111111111111111
1111111111111111111
1111111111111111111
1111111111111111111
1111111111111111111
