START:0,14
TOTAL_TILES:16
COIN_BAGS:
KEYS:
BLOCKS:
TELEPORTS:
1111111111111111111
1111111111111111111
1111111111111111111
1111111111111111111
1111111111111111111
1111111111111111111
1191111111111111111
1BB1111111111111111
1BB1111111111111111
11BB111111111111111
1BBB111111111111111
1BB1111111111111111
11B1111111111111111
11B1111111111111111
ABB1111111111111111
