START:13,7
TOTAL_TILES:16
COIN_BAGS:
KEYS:
BLOCKS:
TELEPORTS:
1111111111111111111
1111111111111111111
1111111111111111111
1111111119111111111
1111111BBB111111111
1111111BBBBBB111111
1111111BB111B111111
111111111111BA11111
111111111111BB11111
1111111111111111111
1111111111111111111
1111111111111111111
1111111111111111111
1111111111111111111
1111111111111111111
