START:6,9
TOTAL_TILES:16
COIN_BAGS:
KEYS:
BLOCKS:
TELEPORTS:
1111111111111111111
1111111111111111111
1111111111111111111
1111111111111111111
1111111111111111111
1111111111111111111
1111111111111111111
119BBB1111111111111
111BBB1111111111111
111BBBA111111111111
1111BBB111111111111
1111BBB111111111111
1111111111111111111
1111111111111111111
1111111111111111111
