START:16,4
TOTAL_TILES:16
COIN_BAGS:
KEYS:
BLOCKS:
TELEPORTS:
1111111111111111111
1111111111111111111
11111111111111BBB11
111111111111BBBBB11
11111111111BB11BA11
1111111111BB1111111
1111111111B11111111
1111111111B91111111
1111111111111111111
1111111111111111111
1111111111111111111
1111111111111111111
1111111111111111111
1111111111111111111
1111111111111111111
