START:13,9
TOTAL_TILES:16
COIN_BAGS:
KEYS:
BLOCKS:
TELEPORTS:
1111111111111111111
1111111111111111111
1111111111111111111
1111111111111111111
1111111111111111111
1111111111111111111
1111111111111111111
1111111111111111111
1111111111BB1111111
1111111111BBBA11111
1111111BBBB11111111
111111BB11111111111
11111BB111111111111
11111BB111111111111
1111119111111111111
