START:10,10
TOTAL_TILES:16
COIN_BAGS:
KEYS:
BLOCKS:
TELEPORTS:
1111111111111111111
1111111111111111111
1111111111111111111
1111111111111111111
1111111111111111111
1111111111111111111
111111111B91BB11111
111111111BB1BB11111
1111111111BBBB11111
1111111111BBBB11111
1111111111A11111111
1111111111111111111
1111111111111111111
1111111111111111111
1111111111111111111
