START:7,6
TOTAL_TILES:16
COIN_BAGS:
KEYS:
BLOCKS:
TELEPORTS:
11191BBBB1111111111
111BBB11B1111111111
11111111B1111111111
11111111BB111111111
111111111B111111111
1111111BBB111111111
1111111A11111111111
1111111111111111111
1111111111111111111
1111111111111111111
1111111111111111111
1111111111111111111
1111111111111111111
1111111111111111111
1111111111111111111
