START:16,13
TOTAL_TILES:16
COIN_BAGS:
KEYS:
BLOCKS:
TELEPORTS:
1111111111111111111
1111111111111111111
1111111111111111111
1111111111111111111
1111111111111111111
11111111111111111B9
11111111111111111B1
11111111111111111B1
1111111111111111BB1
1111111111111111B11
1111111111111111B11
11111111111111BBB11
11111111111111B1111
11111111111111B1A11
11111111111111BBB11
