START:3,13
TOTAL_TILES:16
COIN_BAGS:
KEYS:
BLOCKS:
TELEPORTS:
1111111111111111111
1111111111111111111
1111111111111111111
1111111111111111111
1111111111111111111
1111111111111111111
1111111111111111111
1111111111111111111
1111111111111111111
111119BBB1111111111
1111111BB1111111111
1111BBBB11111111111
11BBB11111111111111
11BA111111111111111
11BB111111111111111
