START:6,11
TOTAL_TILES:16
COIN_BAGS:
KEYS:
BLOCKS:
TELEPORTS:
1111111111111111111
1111111111111111111
1111111111111111111
1111111111111111111
1111111111111111111
1111111111111111111
1111111111111111111
1111111111111111111
1111111111111111111
1111111111111111111
11B9111111111111111
11BBBBAB11111111111
11111B1BB1111111111
11111BB1B1111111111
111111BBB1111111111
