START:18,14
TOTAL_TILES:14
COIN_BAGS:
KEYS:
BLOCKS:
TELEPORTS:
1111111111111111111
1111111111111111111
1111111111111111111
1111111111111111111
1111111111111111111
1111111111111111111
1111111111111111111
1111111111111111111
1111111111111111119
11111111111111111BB
11111111111111111BB
11111111111111111BB
11111111111111111BB
1111111111111111BBB
1111111111111111BBA
