START:7,14
TOTAL_TILES:16
COIN_BAGS:
KEYS:
BLOCKS:
TELEPORTS:
1111111111111111111
1111111111111111111
1111111111111111111
1111111111111111111
1111111111111111111
1111111111111111111
1111111111111111111
1111111111111111111
1111111111111111111
9BB1111111111111111
11BBB11111111111111
111BB11111111111111
11BB111111111111111
11BB111111111111111
111BBBBA11111111111
