START:3,3
TOTAL_TILES:16
COIN_BAGS:
KEYS:
BLOCKS:
TELEPORTS:
1111111111111111111
1111111111111111111
1111111111111111111
11BA111111111111111
1BB1111111111111111
1BBBBB1111111111111
1BB11B1111111111111
11111B1111111111111
11111BB111111111111
111119B111111111111
1111111111111111111
1111111111111111111
1111111111111111111
1111111111111111111
1111111111111111111
