START:10,4
TOTAL_TILES:16
COIN_BAGS:
KEYS:
BLOCKS:
TELEPORTS:
11111111111BBB11111
1111111111191B11111
1111111111111B11111
1111111111111BB1111
1111111111A111B1111
1111111111BBB1B1111
111111111111BBB1111
1111111111111111111
1111111111111111111
1111111111111111111
1111111111111111111
1111111111111111111
1111111111111111111
1111111111111111111
1111111111111111111
