START:15,12
TOTAL_TILES:16
COIN_BAGS:
KEYS:
BLOCKS:
TELEPORTS:
1111111111111111111
1111111111111111111
1111111111111111111
1111111111111111111
1111111111111111111
1111111111111111111
1111111111111111111
1111111111111111111
11111111111BB111111
11111111111BBBB1111
111111111BBB11B1111
111111111B1111B1111
111111111BB111BA111
1111111111911111111
1111111111111111111
