START:15,8
TOTAL_TILES:16
COIN_BAGS:
KEYS:
BLOCKS:
TELEPORTS:
1111111111111111111
1111111111111111111
1111111111111111111
1111111111111111111
1111111111111111111
11111111111B9111111
11111111111B1111111
11111111111BB1BBBB1
111111111111BBBABB1
1111111111111BB1111
1111111111111111111
1111111111111111111
1111111111111111111
1111111111111111111
1111111111111111111
