START:9,13
TOTAL_TILES:16
COIN_BAGS:
KEYS:
BLOCKS:
TELEPORTS:
1111111111111111111
1111111111111111111
1111111111111111111
1111111111111111111
1111111111111111111
1111111111111111111
1111111111111111111
1111111119BB1111111
11111111111B1111111
11111111111B1111111
11111111BBBB1111111
111111BBB1111111111
111111BBBB111111111
111111111A111111111
1111111111111111111
