START:1,0
TOTAL_TILES:16
COIN_BAGS:
KEYS:
BLOCKS:
TELEPORTS:
1A11111111111111111
BB11111111111111111
BB11111111111111111
1B11111111111111111
1B11111111111111111
BB11111111111111111
BB11111111111111111
1B11111111111111111
BB11111111111111111
BB11111111111111111
1911111111111111111
1111111111111111111
1111111111111111111
1111111111111111111
1111111111111111111
