START:2,10
TOTAL_TILES:16
COIN_BAGS:
KEYS:
BLOCKS:
TELEPORTS:
1111111111111111111
1111111111111111111
1111111111111111111
1111111111111111111
1111111111111111111
1111111111111111111
1111111111111111111
1111111111111111111
9111111111111111111
B111111111111111111
BBA1111111111111111
BBB1111111111111111
BBB1111111111111111
BBB1111111111111111
BBB1111111111111111
