START:1,0
TOTAL_TILES:16
COIN_BAGS:
KEYS:
BLOCKS:
TELEPORTS:
BA11111111111111111
B111111111111111111
B111111111111111111
B111111111111111111
BB11111111111111111
BB11111111111111111
B111111111111111111
BB11111111111111111
1B19111111111111111
1BBB111111111111111
1111111111111111111
1111111111111111111
1111111111111111111
1111111111111111111
1111111111111111111
