START:1,8
TOTAL_TILES:16
COIN_BAGS:
KEYS:
BLOCKS:
TELEPORTS:
1111111111111111111
1111111111111111111
1111111111111111111
BBBBBB1111111111111
BB11BB1111111111111
BB11911111111111111
B111111111111111111
BB11111111111111111
1A11111111111111111
1111111111111111111
1111111111111111111
1111111111111111111
1111111111111111111
1111111111111111111
1111111111111111111
