START:14,9
TOTAL_TILES:16
COIN_BAGS:
KEYS:
BLOCKS:
TELEPORTS:
1111111111111111111
1111111111111111111
1111111111111111111
11111111111111119B1
11111111111111111B1
1111111111111111BB1
1111111111111111BB1
1111111111111BBBBB1
1111111111111BBB111
11111111111111AB111
1111111111111111111
1111111111111111111
1111111111111111111
1111111111111111111
1111111111111111111
