START:17,6
TOTAL_TILES:16
COIN_BAGS:
KEYS:
BLOCKS:
TELEPORTS:
1111111111111111111
1111111111111111111
1111111111111111111
1111111111111111111
1111111111111111111
1111111111111111111
11111111111111BBBA1
11111111111111BBB11
11111111111BB1B1111
11111111111B9BB1111
11111111111BBB11111
1111111111111111111
1111111111111111111
1111111111111111111
1111111111111111111
