START:14,7
TOTAL_TILES:16
COIN_BAGS:
KEYS:
BLOCKS:
TELEPORTS:
1111111111111111111
1111111111111111111
1111111111111111111
1111111111111111111
1111111111111111111
1111111111111111111
1111111111111111111
11111111111111A1111
1111111111111BB1111
1111111111111BB1111
11111111111111B1111
11111111111111B1111
11111111111111B1111
111111111BB111B1111
1111111119BBBBB1111
