START:2,6
TOTAL_TILES:16
COIN_BAGS:
KEYS:
BLOCKS:
TELEPORTS:
11BB911111111111111
1BB1111111111111111
1BB1111111111111111
11BB111111111111111
111BB11111111111111
1BBBB11111111111111
1BA1111111111111111
1111111111111111111
1111111111111111111
1111111111111111111
1111111111111111111
1111111111111111111
1111111111111111111
1111111111111111111
1111111111111111111
