START:5,9
TOTAL_TILES:16
COIN_BAGS:
KEYS:
BLOCKS:
TELEPORTS:
1111111111111111111
1111111111111111111
1111111111111111111
1111111111111111111
1111111111111111111
1111111111111111111
1111111111111111111
1111111111111111111
1111111111111111111
11111AB111111111111
111111B111111111111
11111BB111111111111
1BBBBB1111111111111
1BBBB11111111111111
1BB1911111111111111
