START:0,1
TOTAL_TILES:16
COIN_BAGS:
KEYS:
BLOCKS:
TELEPORTS:
1BB1111111111111111
ABB1111111111111111
11BB11B911111111111
111B11B111111111111
111BBBB111111111111
1111BB1111111111111
1111111111111111111
1111111111111111111
1111111111111111111
1111111111111111111
1111111111111111111
1111111111111111111
1111111111111111111
1111111111111111111
1111111111111111111
