START:5,9
TOTAL_TILES:16
COIN_BAGS:
KEYS:
BLOCKS:
TELEPORTS:
1111111111111111111
1111111111111111111
1111111111111111111
1111111BB1111111111
11111BBBB1111111111
11111B11B1111111111
11111B1BB1111111111
11111BB911111111111
11111BB111111111111
11111A1111111111111
1111111111111111111
1111111111111111111
1111111111111111111
1111111111111111111
1111111111111111111
