START:9,12
TOTAL_TILES:16
COIN_BAGS:
KEYS:
BLOCKS:
TELEPORTS:
1111111111111111111
1111111111111111111
1111111111111111111
1111111111111111111
1111111111111111111
1111111111111111111
1111111111111111111
1111111111111111111
11111111111111BB111
111111111BB111BB911
111111111BBBBBB1111
111111111BB11111111
111111111AB11111111
1111111111111111111
1111111111111111111
