START:3,0
TOTAL_TILES:16
COIN_BAGS:
KEYS:
BLOCKS:
TELEPORTS:
111ABB1111111111111
11111BB111111111111
11111BB111111111111
11111BBBB1111111111
1111111BB1111111111
1111111B11111111111
111119BB11111111111
1111111111111111111
1111111111111111111
1111111111111111111
1111111111111111111
1111111111111111111
1111111111111111111
1111111111111111111
1111111111111111111
