START:5,5
TOTAL_TILES:16
COIN_BAGS:
KEYS:
BLOCKS:
TELEPORTS:
1111111111111111111
1111111BB1111111111
1111111BB1111111111
11111BBBB1111111111
11111BB1B1111111111
11111AB1BBB11111111
1111111111911111111
1111111111111111111
1111111111111111111
1111111111111111111
1111111111111111111
1111111111111111111
1111111111111111111
1111111111111111111
1111111111111111111
