START:9,4
TOTAL_TILES:16
COIN_BAGS:
KEYS:
BLOCKS:
TELEPORTS:
1111111111111111111
1111111111111111111
1111111111111111111
1111111111111111111
111111111A111111111
111111111BB11111111
1111111111B11111111
1111111111BBBB11111
1111111111BB1B11111
1111111111111B11111
1111111111111BBB111
111111111111119B111
1111111111111111111
1111111111111111111
1111111111111111111
