START:11,5
TOTAL_TILES:16
COIN_BAGS:
KEYS:
BLOCKS:
TELEPORTS:
1111111111111111111
1111111111111111111
1111111111111111111
1111111111111111111
1111111111111111111
11111111111A1111111
11111111111BBB11111
1111111111111BB1111
11111111119111B1111
1111111111BB11BB111
11111111111BBBBB111
1111111111111111111
1111111111111111111
1111111111111111111
1111111111111111111
