START:17,3
TOTAL_TILES:16
COIN_BAGS:
KEYS:
BLOCKS:
TELEPORTS:
1111111111111111111
1111111111111111111
1111111111111111111
11111111111111111A1
11111111111111111BB
1111111111111111BBB
1111111111111111B11
1111111111111111BBB
11111111111111111BB
11111111111111111B1
11111111111111111BB
111111111111111119B
1111111111111111111
1111111111111111111
1111111111111111111
