START:15,1
TOTAL_TILES:16
COIN_BAGS:
KEYS:
BLOCKS:
TELEPORTS:
1111111111111111111
111111111111111AB11
1111111111111111B11
1111111111111111BB1
11111111111111111BB
111111111111111111B
11111111111111111BB
11111111111111111BB
11111111111111111BB
11111111111111111BB
1111111111111111119
1111111111111111111
1111111111111111111
1111111111111111111
1111111111111111111
