START:13,13
TOTAL_TILES:16
COIN_BAGS:
KEYS:
BLOCKS:
TELEPORTS:
1111111111111111111
1111111111111111111
1111111111111111111
1111111111111111111
1111111111111111111
1111111111111111111
1111111111111111111
1111111111111111111
1111111111111111111
11111111111111BBB11
11111111111111B1B11
111111111111BBB1BB1
111111111111BB111B1
1111111111111A111BB
1111111111111111119
