START:11,9
TOTAL_TILES:14
COIN_BAGS:
KEYS:
BLOCKS:
TELEPORTS:
1111111111111111111
1111111111111111111
1111111111111111111
1111111111111111111
1111111111111111111
1111111111111111111
1111111111111111111
1111111111111111111
1111111111BBB111111
1111111111BAB111111
1111111111BBBB11111
1111111111111BB1111
11111111111111B1111
11111111111111B1111
1111111111111191111
