START:15,4
TOTAL_TILES:16
COIN_BAGS:
KEYS:
BLOCKS:
TELEPORTS:
1111111111111BB1111
111111111111BBB1111
111111111111B9B1111
111111111111BB11111
1111111111111B1A111
1111111111111BBB111
1111111111111BB1111
1111111111111111111
1111111111111111111
1111111111111111111
1111111111111111111
1111111111111111111
1111111111111111111
1111111111111111111
1111111111111111111
