START:8,8
TOTAL_TILES:16
COIN_BAGS:
KEYS:
BLOCKS:
TELEPORTS:
1111111111111111111
1111111111111111111
1111111111111111111
1111111111BB1111111
1111111111BB1111111
1111111111BB1111111
1111111111BBB111111
1111111111BBB111111
11111111ABBB9111111
1111111111111111111
1111111111111111111
1111111111111111111
1111111111111111111
1111111111111111111
1111111111111111111
