START:1,1
TOTAL_TILES:16
COIN_BAGS:
KEYS:
BLOCKS:
TELEPORTS:
1111111111111111111
1A11111111111111111
1B1BB11111111111111
1BBBB11111111111111
1BB1BB1111111111111
1111BB1111111111111
1111B11111111111111
1119B11111111111111
1111111111111111111
1111111111111111111
1111111111111111111
1111111111111111111
1111111111111111111
1111111111111111111
1111111111111111111
