START:6,0
TOTAL_TILES:16
COIN_BAGS:
KEYS:
BLOCKS:
TELEPORTS:
111111AB11111111111
1111111BB9111111111
1111111BBB111111111
1111111BBB111111111
11111111BB111111111
11111111BB111111111
11111111BB111111111
1111111111111111111
1111111111111111111
1111111111111111111
1111111111111111111
1111111111111111111
1111111111111111111
1111111111111111111
1111111111111111111
