START:14,7
TOTAL_TILES:93
COIN_BAGS:6,3
KEYS:
BLOCKS:
..################.
.##~~~~~~~~~~~~~~#.
.#~~####@@~~~~@~~#.
.#~~~@~~~~~~~~@~~#.
.###~@###~####~###.
...#~@###F#~~#~#...
.###~@#####~~#~#...
.#~~~~~####~~#~#...
.#~###~~~~~~~###...
.#~###~~~~~#~#.....
.#~~~~~###~~~#.....
.#######.#####.....
...................
...................
...................
