START:7,11
TOTAL_TILES:132
COIN_BAGS:6,3
KEYS:16,7
BLOCKS:7,8
TELEPORTS:
1111110001111000000
1BBBB10001BB1110000
1BBBB11101BBBB10000
11BBBB8111BBBB11000
01BBBBCBB1BBBCB1100
11B11BB1B11BBBCB100
1BB11BBBCBBBBBB1110
1BBB1BBCBBBBBBBBB10
1BBB1B16111B1BBBB10
11BB1BBCBB1CBBB1110
11B111111B1BBBCB100
01B1111ABB1BBCB1100
01B4B91BBB1BBB11000
01D1111BBB11BB10000
0111001111111110000
