START:15,11
TOTAL_TILES:133
COIN_BAGS:8,13
KEYS:6,9
BLOCKS:
TELEPORTS:
0000000000000011100
0000000000000019100
000000000000111B111
0011111111111CBCBC1
001BBBBBBBB11C1B1C1
001BBB1111BB1BBCBB1
001BBBBCB1BB111B111
0111CB1BB1BBCB1B111
01BBC111B111B114111
01B1BBB1CBBBB1BCCC1
01B1B1B1C1BBB1B11C1
01BBC1B1B1BBB1BA1C1
0111BBCCB1BBB1111C1
0001BB1B81BBCCCCCC1
0001111111111111111
