START:3,5
TOTAL_TILES:183
COIN_BAGS:17,1
KEYS:2,1
BLOCKS:16,10
1111111111111111111
11BBBBBBBBBBBBBBB81
1DBBBBBBBBBBBBB7BB1
11111BBBCBBBBBBBBB1
11111B17CBBBBBBB1B1
111ABB1BCBBBBBBB1B1
1111111BBBBBBBBBBB1
1119BB1BBBBBBBBBBB1
1111141BBBBBBBBB1B1
11111CCBBB1BBBBB1B1
1BBBCBBBBB1BBBBB6B1
1B11CB1BBBBBBBBBBB1
1B11CCBBBBBBBBBB1B1
1BBBCB11BB11BB1BBB1
1111111111111111111
