START:15,11
TOTAL_TILES:130
COIN_BAGS:9,7
KEYS:1,9
BLOCKS:5,9
0000000111101110000
00111111BB111B10000
001BB1BBBCBBCC10000
001BBBBBBB11BB10000
001B111BBBBBBB11000
001B1D11111CCCB1000
001CBBBBBBBCBB11000
001B1B11B8BCCC10000
111B1B1BBBBBBC10000
1B1B161BBBBCCC10000
1C1B1B11111CB111110
1C1BCB19B4BC11BAB10
1C11C111111BBBCBB10
1CCCC10000111111110
1111110000000000000
