START:5,12
TOTAL_TILES:228
COIN_BAGS:9,5
KEYS:1,9
BLOCKS:5,8
1111111111111111111
1BBBBBBBB1CC1CCBBB1
1B11BBBBBBCCCCB1BB1
1BBBBBBBBBCCCCB1411
1BBBBBBBBBCCCCB1B91
1BBBBBCCC8CBBBB1111
1BBBBBCBCCCBBBBBBB1
1BBBBBCBBBBBBBBBBB1
11CCC6BBBBBBCBBBBB1
1DCCCCBBBBBBBBBBBB1
1BB1BBBBBBBBBB11BB1
1BBBBBBBBBBBBB11111
1B1B1A1B1BBBBBBBBB1
1BBB111BBBBBBBBBBB1
1111111111111111111
