START:14,7
TOTAL_TILES:94
COIN_BAGS:6,3
KEYS:
BLOCKS:
0011111111111111110
011BBBBBBBBBBBBBB10
01BB1111CCBBBBCBB10
01BBBC8BBBBBBBCBB10
0111BC111B1111B1110
0001BC11191BB1B1000
0111BC11111BB1B1000
01BBBBB1111BB1A1000
01B111BBBBBBB111000
01B111BBBBB1B100000
01BBBBB111BBB100000
0111111101111100000
0000000000000000000
0000000000000000000
0000000000000000000
