START:3,7
TOTAL_TILES:134
COIN_BAGS:
KEYS:15,12
BLOCKS:12,7
TELEPORTS:10,7;7,11
1111111111111111111
191BBBBBBBBBB111111
1BBBBB111BBBB111111
1111BB1D1BBBB111111
1BBBBBBBBBBBB111111
1B1BBBBBBBBBB111111
1B111BBBBBBBB111111
141ABBBBBB7B6111111
1B111BBBBBCBB111111
1B1CCBBBB1B1B111111
1CBCB1BBB1BBB111111
1B1B11B7B1BBBB11111
1BBCB1BBB1BBBCCB111
1BBBB11111BB1111111
1111111111111111111
