START:2,10
TOTAL_TILES:20
COIN_BAGS:
KEYS:
BLOCKS:
0000000000000000000
0000000000000000000
0000000000000000000
0000000000000000000
0000000000000000000
0000000000000000000
0000000000000111000
0000011111110191000
000001BBBBB101B1000
011111B111B111B1000
01ABBBB101BBBBB1000
0111111101111111000
0000000000000000000
0000000000000000000
0000000000000000000
