START:14,7
TOTAL_TILES:42
COIN_BAGS:9,10
KEYS:
BLOCKS:
0000000000000000000
0000000000000000000
0000000000000000000
0000000000000000000
0000000000000000000
0000000000000000000
0000000000000111000
00000000000001A1000
00011111111111B1110
0111BBBBBBBBBBBBB10
019BBBBBB8BBBBBBB10
01111BBBBBBBBBBBB10
0000111111111111110
0000000000000000000
0000000000000000000
