START:14,7
TOTAL_TILES:26
COIN_BAGS:
KEYS:
BLOCKS:
TELEPORTS:
0000000000000000000
0000000000000000000
0000000000000000000
0000000000000000000
0000000000000000000
0000000000000000000
0011100000000111000
00191000000001A1000
001B1111100001B1000
001B11BB111111B1000
001BBBBBBBBBBBB1000
001BB1111BB11BB1000
0011110011111111000
0000000000000000000
0000000000000000000
