START:6,5
TOTAL_TILES:83
COIN_BAGS:2,10
KEYS:
BLOCKS:
TELEPORTS:
0000000000000000000
0000000000000000000
0000000000000000000
1111100011111000000
1BBB11111BBB1000000
1B1B11A11B1B1000000
1BBCBBCBBCBB1111000
111B11B11B111191000
011B11B11B1111B1000
01BBBBCBBCBB1BB1100
018BB1B11B1B1BBB100
01BBBBB11BBB11BB100
01BB1111111111BB100
011BBBBBBBBBBBBB100
0011111111111111100
