START:6,5
TOTAL_TILES:82
COIN_BAGS:2,10
KEYS:
BLOCKS:
...................
...................
...................
#####...#####......
#~~~#####~~~#......
#~#~##~##~#~#......
#~~@~~@~~@~~####...
###~##~##~####F#...
.##~##~##~####~#...
.#~~~~@~~@~~#~~##..
.#~~~#~##~#~#~~~#..
.#~~~~~##~~~##~~#..
.#~~##########~~#..
.##~~~~~~~~~~~~~#..
..###############..
