START:9,5
TOTAL_TILES:209
COIN_BAGS:14,5
KEYS:1,1
BLOCKS:
1111111111111111111
1BBBBBBBBBBBBBBBBB1
1BBBCCCCCCCCBBBBCB1
1BBBBBBBBBBBBBBBCB1
1BBBBBB111111BBBCB1
1BBBBBB11A11CC8BCB1
1BBBBBB11B11CCBBBB1
1BBBBBBBBBBBBBBBBB1
1BBBBBBBBBBBBBBBBB1
1BBBBBB111BBBB111B1
1BBBBBBBBBCCCC4B1B1
1B111BB111BBBB191B1
1B11BCCBBBBBBB111B1
1BBBBBBBBBBBBBBBBB1
1111111111111111111
