START:2,10
TOTAL_TILES:42
COIN_BAGS:10,11
KEYS:
BLOCKS:
0000000000000000000
0000000000000000000
0000000000000000000
0000000000000000000
0000000000000000000
0000000000000000000
0000000000000111000
0000000000000191000
00001111111111B1110
01111BBB1BBBB1BBB10
01ABBBBBBBBBB1BBB10
0111BBBBBB8BBBBBB10
0001111BBB111111110
0000001111100000000
0000000000000000000
