START:14,7
TOTAL_TILES:26
COIN_BAGS:
KEYS:
BLOCKS:
TELEPORTS:
0000000000000000000
0000000000000000000
0000000000000000000
0000000000000000000
0000000000000000000
0000000000000000000
0011100000000111000
00191000000001A1000
001B1000011111B1000
001B111111BB11B1000
001BBBBBBBBBBBB1000
001BB11BB1111BB1000
0011111111001111000
0000000000000000000
0000000000000000000
