START:2,10
TOTAL_TILES:19
COIN_BAGS:
KEYS:
BLOCKS:
...................
...................
...................
...................
...................
...................
.............###...
.............#F#...
.............#~#...
.#######.#####~#...
.#~~~~~#.#~~~~~#...
.#####~###~#####...
.....#~~~~~#.......
.....#######.......
...................
