START:6,5
TOTAL_TILES:83
COIN_BAGS:2,10
KEYS:
BLOCKS:
0000000000000000000
0000000000000000000
0000000000000000000
1111100011111000000
1BBB11111BBB1000000
1B1B11A11B1B1000000
1BBCBBCBBCBB1111000
111B11B11B111191000
011B11B11B1111B1100
01BBBBCBBCBB11BB100
018BB1B11B1B1BBB100
01BBBBB11BBB1B11100
01B1111111111BBB100
01BBBBBBBBBBBBBB100
0111111111111111100
