START:15,1
TOTAL_TILES:139
COIN_BAGS:10,7
KEYS:4,13
BLOCKS:
0000001111011111100
0000001BB111BB1A100
0000001BCBBBCB1B100
00000111B111B11B110
111111BBC111BBBCB10
1BB111B1B1B1B11B110
1BCBBBCBCBC1CBBC100
1BCBBBB1B181B11B100
1BCC1CCBCBCBCB1B111
1BCC1BB1B1B1B11BBB1
1BCC11BBCBCBCB11141
1BCC11BB11B1BB19BB1
1BCCB11111111111111
1BBBB10000000000000
1111110000000000000
