START:17,4
TOTAL_TILES:183
COIN_BAGS:5,9
KEYS:17,13
BLOCKS:14,5
1111111111111111111
1BBCBBB11BBBB1BBBB1
1B1BBBBBBBBBBBCBBB1
1BBB11BBBB111BB1111
111B111BBB111BBBBA1
11BB111B1B11BB6BBB1
11BBBBBCBCBBBBBBBB1
111BBB1B1B1BBBBBB11
111BBCBCBCBBBBBBB11
1BBBB81B1B111111111
1BBCBBBCBCBB1BBBBC1
1BBB1BBCBCBB14191C1
1BBBBBBB1BBBBC111C1
1BB1BBBB1D1BBCCCCC1
1111111111111111111
